rank_number,actor,contributions,percent,cumulative_sum,cumulative_percent,all_contributions
1,sivanantha321,2656,5.36414,2656,5.36414,49514
2,Jooho,1293,2.61138,3949,7.97552,49514
3,alexagriffith,582,1.17543,4531,9.15095,49514
4,rafvasq,550,1.11080,5081,10.26174,49514
5,israel-hdez,535,1.08050,5616,11.34225,49514
6,greenmoon55,440,0.88864,6056,12.23088,49514
7,yuzliu,412,0.83209,6468,13.06297,49514
8,Suresh-Nakkeran,403,0.81391,6871,13.87688,49514
9,gavrissh,265,0.53520,7136,14.41209,49514
10,tjohnson31415,215,0.43422,7351,14.84631,49514
11,Datta0,124,0.25043,7475,15.09674,49514
12,tteofili,121,0.24438,7596,15.34112,49514
13,cmaddalozzo,115,0.23226,7711,15.57337,49514
14,gavrishp,115,0.23226,7826,15.80563,49514
15,hdefazio,115,0.23226,7941,16.03789,49514
16,VedantMahabaleshwarkar,107,0.21610,8048,16.25399,49514
17,SeibertronSS,87,0.17571,8135,16.42970,49514
18,tessapham,82,0.16561,8217,16.59531,49514
19,brettmthompson,76,0.15349,8293,16.74880,49514
20,HotsauceLee,69,0.13935,8362,16.88815,49514
21,aluu317,68,0.13733,8430,17.02549,49514
22,LogicalGuy77,68,0.13733,8498,17.16282,49514
23,andresllh,65,0.13128,8563,17.29410,49514
24,cjohannsen-cloudera,65,0.13128,8628,17.42537,49514
25,yurkoff-mv,60,0.12118,8688,17.54655,49514
26,AnyISalIn,56,0.11310,8744,17.65965,49514
27,edenbuaa,49,0.09896,8793,17.75861,49514
28,deadeyegoodwin,47,0.09492,8840,17.85354,49514
29,hustxiayang,46,0.09290,8886,17.94644,49514
30,LOADBC,42,0.08482,8928,18.03126,49514
31,tjandy98,40,0.08079,8968,18.11205,49514
32,ontheway16,38,0.07675,9006,18.18880,49514
33,AyushSawant18588,37,0.07473,9043,18.26352,49514
34,daganida88,37,0.07473,9080,18.33825,49514
35,bentohset,36,0.07271,9116,18.41095,49514
36,lynnmatrix,36,0.07271,9152,18.48366,49514
37,kevinmingtarja,35,0.07069,9187,18.55435,49514
38,TimKleinloog,35,0.07069,9222,18.62504,49514
39,zoramt,32,0.06463,9254,18.68966,49514
40,xfu83,31,0.06261,9285,18.75227,49514
41,hakuro95,29,0.05857,9314,18.81084,49514
42,anhuong,28,0.05655,9342,18.86739,49514
43,ritzdevp,28,0.05655,9370,18.92394,49514
44,edi-bice-by,27,0.05453,9397,18.97847,49514
45,Griffin-Sullivan,27,0.05453,9424,19.03300,49514
46,HAO2167,27,0.05453,9451,19.08753,49514
47,varunsh-xilinx,27,0.05453,9478,19.14206,49514
48,R3hankhan123,26,0.05251,9504,19.19457,49514
49,rtrobin,26,0.05251,9530,19.24708,49514
50,adilhusain-s,25,0.05049,9555,19.29757,49514
51,decewei,25,0.05049,9580,19.34806,49514
52,hhk7734,25,0.05049,9605,19.39855,49514
53,jiwang576,25,0.05049,9630,19.44904,49514
54,valentin-stefan-popa,25,0.05049,9655,19.49954,49514
55,danielezonca,24,0.04847,9679,19.54801,49514
56,RobGeada,24,0.04847,9703,19.59648,49514
57,Agarwal-Saurabh,23,0.04645,9726,19.64293,49514
58,nilakshi104,23,0.04645,9749,19.68938,49514
59,park12sj,23,0.04645,9772,19.73583,49514
60,haijohn,22,0.04443,9794,19.78026,49514
61,SebastianScherer88,22,0.04443,9816,19.82470,49514
62,haoxins,21,0.04241,9837,19.86711,49514
63,guohaoyu110,20,0.04039,9857,19.90750,49514
64,haiminh2001,20,0.04039,9877,19.94789,49514
65,MessKon,20,0.04039,9897,19.98829,49514
66,shrinath-suresh,20,0.04039,9917,20.02868,49514
67,bmopuri,19,0.03837,9936,20.06705,49514
68,joerunde,19,0.03837,9955,20.10542,49514
69,jyono,19,0.03837,9974,20.14380,49514
70,mholder6,19,0.03837,9993,20.18217,49514
71,Phelan164,19,0.03837,10012,20.22054,49514
72,Rstar1998,19,0.03837,10031,20.25892,49514
73,taneem-ibrahim,19,0.03837,10050,20.29729,49514
74,asdqwe123zxc,18,0.03635,10068,20.33364,49514
75,C1berwiz,18,0.03635,10086,20.37000,49514
76,reconlabs-luke,18,0.03635,10104,20.40635,49514
77,biswassri,17,0.03433,10121,20.44068,49514
78,cbalbera-imaige,17,0.03433,10138,20.47502,49514
79,saileshd1402,17,0.03433,10155,20.50935,49514
80,sindhuvahinis,17,0.03433,10172,20.54368,49514
81,de0725,16,0.03231,10188,20.57600,49514
82,dtrifiro,16,0.03231,10204,20.60831,49514
83,GolanLevy,16,0.03231,10220,20.64063,49514
84,molejnik-mergebit,16,0.03231,10236,20.67294,49514
85,ops-jaeha,16,0.03231,10252,20.70526,49514
86,VikasAbhishek,16,0.03231,10268,20.73757,49514
87,andreapairon,15,0.03029,10283,20.76786,49514
88,anurags25,15,0.03029,10298,20.79816,49514
89,ArjunBhalla98,15,0.03029,10313,20.82845,49514
90,homily707,15,0.03029,10328,20.85875,49514
91,KimSoungRyoul,15,0.03029,10343,20.88904,49514
92,WHITE-ICE-BOX,15,0.03029,10358,20.91934,49514
93,yc2984,15,0.03029,10373,20.94963,49514
94,zijianjoy,15,0.03029,10388,20.97992,49514
95,FabianScheidt,14,0.02827,10402,21.00820,49514
96,hyche,14,0.02827,10416,21.03647,49514
97,jinan-zhou,14,0.02827,10430,21.06475,49514
98,jmalobicky,14,0.02827,10444,21.09302,49514
99,navneetraju,14,0.02827,10458,21.12130,49514
100,serdarildercaglar,14,0.02827,10472,21.14957,49514
101,ShreehariVaasishta,14,0.02827,10486,21.17785,49514
102,tiansiyuan,14,0.02827,10500,21.20612,49514
103,631068264,13,0.02626,10513,21.23238,49514
104,AlexFly666,13,0.02626,10526,21.25863,49514
105,leduckhc,13,0.02626,10539,21.28489,49514
106,pvgbabu,13,0.02626,10552,21.31114,49514
107,robertgshaw2-neuralmagic,13,0.02626,10565,21.33740,49514
108,SatishReddyBethi,13,0.02626,10578,21.36365,49514
109,xvnyv,13,0.02626,10591,21.38991,49514
110,yolk-pie-L,13,0.02626,10604,21.41617,49514
111,Yucao42,13,0.02626,10617,21.44242,49514
112,abhisheksinghblr,12,0.02424,10629,21.46666,49514
113,benkawecki,12,0.02424,10641,21.49089,49514
114,DontStopMeNow,12,0.02424,10653,21.51513,49514
115,hclchimumu,12,0.02424,10665,21.53936,49514
116,kittywaresz,12,0.02424,10677,21.56360,49514
117,oplushappy,12,0.02424,10689,21.58783,49514
118,ajstewart,11,0.02222,10700,21.61005,49514
119,datta-nimmaturi,11,0.02222,10711,21.63227,49514
120,edwardzjl,11,0.02222,10722,21.65448,49514
121,hehe04,11,0.02222,10733,21.67670,49514
122,IntelliJJ824,11,0.02222,10744,21.69891,49514
123,isaranto,11,0.02222,10755,21.72113,49514
124,kangwoo,11,0.02222,10766,21.74335,49514
125,lifo9,11,0.02222,10777,21.76556,49514
126,Naegionn,11,0.02222,10788,21.78778,49514
127,nguyenthai0107,11,0.02222,10799,21.80999,49514
128,safoinme,11,0.02222,10810,21.83221,49514
129,shahar3012,11,0.02222,10821,21.85443,49514
130,vaporpin,11,0.02222,10832,21.87664,49514
131,Wercurial,11,0.02222,10843,21.89886,49514
132,bestowjay,10,0.02020,10853,21.91905,49514
133,dsgli,10,0.02020,10863,21.93925,49514
134,dumbPy,10,0.02020,10873,21.95945,49514
135,iamshwin,10,0.02020,10883,21.97964,49514
136,MikhailKravets,10,0.02020,10893,21.99984,49514
137,papagala,10,0.02020,10903,22.02003,49514
138,revolutionisme,10,0.02020,10913,22.04023,49514
139,suryaiyer,10,0.02020,10923,22.06043,49514
140,yangyang919,10,0.02020,10933,22.08062,49514
141,Anarocha252,9,0.01818,10942,22.09880,49514
142,bartgras,9,0.01818,10951,22.11698,49514
143,ChaejinE,9,0.01818,10960,22.13515,49514
144,christinaexyou,9,0.01818,10969,22.15333,49514
145,gcemaj,9,0.01818,10978,22.17151,49514
146,hsinhoyeh,9,0.01818,10987,22.18968,49514
147,janwytze,9,0.01818,10996,22.20786,49514
148,juhyeon-cha,9,0.01818,11005,22.22604,49514
149,luranhe,9,0.01818,11014,22.24421,49514
150,mmoya91,9,0.01818,11023,22.26239,49514
151,prgawade,9,0.01818,11032,22.28057,49514
152,sammy04,9,0.01818,11041,22.29874,49514
153,alokumar1,8,0.01616,11049,22.31490,49514
154,asd981256,8,0.01616,11057,22.33106,49514
155,austynherman,8,0.01616,11065,22.34721,49514
156,dangermike,8,0.01616,11073,22.36337,49514
157,HutakiHare,8,0.01616,11081,22.37953,49514
158,JakeNeyer,8,0.01616,11089,22.39569,49514
159,JasmondL,8,0.01616,11097,22.41184,49514
160,jiaqianjing,8,0.01616,11105,22.42800,49514
161,jpatanooga,8,0.01616,11113,22.44416,49514
162,Manindhar,8,0.01616,11121,22.46031,49514
163,mdrijwan123,8,0.01616,11129,22.47647,49514
164,Nagarajj,8,0.01616,11137,22.49263,49514
165,Omoong,8,0.01616,11145,22.50879,49514
166,sam0996,8,0.01616,11153,22.52494,49514
167,songm28,8,0.01616,11161,22.54110,49514
168,Syntax-Error-1337,8,0.01616,11169,22.55726,49514
169,szymonbcoding,8,0.01616,11177,22.57341,49514
170,xcjason,8,0.01616,11185,22.58957,49514
171,zozowell,8,0.01616,11193,22.60573,49514
172,abrbird,7,0.01414,11200,22.61987,49514
173,alekseyolg,7,0.01414,11207,22.63400,49514
174,amacharya,7,0.01414,11214,22.64814,49514
175,bhagyashrigai,7,0.01414,11221,22.66228,49514
176,chirag-orbittec,7,0.01414,11228,22.67641,49514
177,csy1204,7,0.01414,11235,22.69055,49514
178,davidliu40313,7,0.01414,11242,22.70469,49514
179,disrupted,7,0.01414,11249,22.71883,49514
180,dpnoworyta,7,0.01414,11256,22.73296,49514
181,ericlu88,7,0.01414,11263,22.74710,49514
182,georgetree,7,0.01414,11270,22.76124,49514
183,GetOn4,7,0.01414,11277,22.77538,49514
184,IonBoleac,7,0.01414,11284,22.78951,49514
185,jerryharrow,7,0.01414,11291,22.80365,49514
186,JohnsonWang1015,7,0.01414,11298,22.81779,49514
187,Jonas-Bruns,7,0.01414,11305,22.83193,49514
188,juangon,7,0.01414,11312,22.84606,49514
189,kyuwoo-choi,7,0.01414,11319,22.86020,49514
190,LaPetiteSouris,7,0.01414,11326,22.87434,49514
191,lgdeloss,7,0.01414,11333,22.88848,49514
192,lmyslinski,7,0.01414,11340,22.90261,49514
193,manstis,7,0.01414,11347,22.91675,49514
194,melowYX,7,0.01414,11354,22.93089,49514
195,mhowell24,7,0.01414,11361,22.94503,49514
196,muratyarali,7,0.01414,11368,22.95916,49514
197,nagar-ajay,7,0.01414,11375,22.97330,49514
198,nicozhang,7,0.01414,11382,22.98744,49514
199,nishank-lily,7,0.01414,11389,23.00158,49514
200,peterableda,7,0.01414,11396,23.01571,49514
201,r00ta,7,0.01414,11403,23.02985,49514
202,ryojsb,7,0.01414,11410,23.04399,49514
203,saeid93,7,0.01414,11417,23.05812,49514
204,tongtaott,7,0.01414,11424,23.07226,49514
205,WaterKnight1998,7,0.01414,11431,23.08640,49514
206,yungParrot,7,0.01414,11438,23.10054,49514
207,zhaque44,7,0.01414,11445,23.11467,49514
208,anhquan075,6,0.01212,11451,23.12679,49514
209,animesh-agarwal,6,0.01212,11457,23.13891,49514
210,AshleyZhao,6,0.01212,11463,23.15103,49514
211,aurorazl,6,0.01212,11469,23.16315,49514
212,averyngo34,6,0.01212,11475,23.17526,49514
213,bdattoma,6,0.01212,11481,23.18738,49514
214,caamartin35,6,0.01212,11487,23.19950,49514
215,capt2101akash,6,0.01212,11493,23.21162,49514
216,cceyda,6,0.01212,11499,23.22373,49514
217,celinew1221,6,0.01212,11505,23.23585,49514
218,d123456temp,6,0.01212,11511,23.24797,49514
219,daniel-weisse,6,0.01212,11517,23.26009,49514
220,devarsh10,6,0.01212,11523,23.27221,49514
221,erickrf,6,0.01212,11529,23.28432,49514
222,fsatka,6,0.01212,11535,23.29644,49514
223,guitouni,6,0.01212,11541,23.30856,49514
224,huazq,6,0.01212,11547,23.32068,49514
225,jidemoski,6,0.01212,11553,23.33279,49514
226,jinholee-makinarocks,6,0.01212,11559,23.34491,49514
227,juanvasquezreyes,6,0.01212,11565,23.35703,49514
228,jw-websensa,6,0.01212,11571,23.36915,49514
229,Lewiky,6,0.01212,11577,23.38127,49514
230,lswjkllc,6,0.01212,11583,23.39338,49514
231,meijies,6,0.01212,11589,23.40550,49514
232,mmeendez8,6,0.01212,11595,23.41762,49514
233,mumarniaz,6,0.01212,11601,23.42974,49514
234,nongqiqin,6,0.01212,11607,23.44185,49514
235,Ranjith11903952,6,0.01212,11613,23.45397,49514
236,rileygreen-ncs,6,0.01212,11619,23.46609,49514
237,roseaysina,6,0.01212,11625,23.47821,49514
238,skuchipu,6,0.01212,11631,23.49033,49514
239,smhgit,6,0.01212,11637,23.50244,49514
240,SNagappan,6,0.01212,11643,23.51456,49514
241,Subhankar-Adak,6,0.01212,11649,23.52668,49514
242,takamai06,6,0.01212,11655,23.53880,49514
243,tanvithakur94,6,0.01212,11661,23.55091,49514
244,tmbochenski,6,0.01212,11667,23.56303,49514
245,vulong3896,6,0.01212,11673,23.57515,49514
246,wave112,6,0.01212,11679,23.58727,49514
247,Zeashh,6,0.01212,11685,23.59939,49514
248,aayushsss1,5,0.01010,11690,23.60948,49514
249,agoston,5,0.01010,11695,23.61958,49514
250,akagami-harsh,5,0.01010,11700,23.62968,49514
251,AkashDharani,5,0.01010,11705,23.63978,49514
252,AKnowlesAtDigit,5,0.01010,11710,23.64988,49514
253,calwoo,5,0.01010,11715,23.65997,49514
254,capoolebugchat,5,0.01010,11720,23.67007,49514
255,Cheng8994,5,0.01010,11725,23.68017,49514
256,Cretus-iosDev,5,0.01010,11730,23.69027,49514
257,Debabrata47,5,0.01010,11735,23.70037,49514
258,djmcgreal-cc,5,0.01010,11740,23.71047,49514
259,dugar-tarun-z,5,0.01010,11745,23.72056,49514
260,future-xy,5,0.01010,11750,23.73066,49514
261,gigabyte132,5,0.01010,11755,23.74076,49514
262,goswamig,5,0.01010,11760,23.75086,49514
263,Hmr-ramzi,5,0.01010,11765,23.76096,49514
264,hoanhvong,5,0.01010,11770,23.77105,49514
265,jared-cloudera,5,0.01010,11775,23.78115,49514
266,Jason4849,5,0.01010,11780,23.79125,49514
267,Jensxy,5,0.01010,11785,23.80135,49514
268,jinserk,5,0.01010,11790,23.81145,49514
269,kaydxh,5,0.01010,11795,23.82155,49514
270,lionl1106,5,0.01010,11800,23.83164,49514
271,lloydhamilton,5,0.01010,11805,23.84174,49514
272,luntropy,5,0.01010,11810,23.85184,49514
273,magicmopper,5,0.01010,11815,23.86194,49514
274,MatthiasVDDooren,5,0.01010,11820,23.87204,49514
275,MeranaTona,5,0.01010,11825,23.88213,49514
276,Mgla96,5,0.01010,11830,23.89223,49514
277,MichalPitr,5,0.01010,11835,23.90233,49514
278,nickaggarwal,5,0.01010,11840,23.91243,49514
279,nilayaishwarya,5,0.01010,11845,23.92253,49514
280,oyy2000,5,0.01010,11850,23.93263,49514
281,pallav0894,5,0.01010,11855,23.94272,49514
282,pkurzend,5,0.01010,11860,23.95282,49514
283,pmtk,5,0.01010,11865,23.96292,49514
284,PSKP-95,5,0.01010,11870,23.97302,49514
285,TalhaNaeem101,5,0.01010,11875,23.98312,49514
286,vi-kas,5,0.01010,11880,23.99321,49514
287,vikas-saxena02,5,0.01010,11885,24.00331,49514
288,wayzeng,5,0.01010,11890,24.01341,49514
289,5uperpalo,4,0.00808,11894,24.02149,49514
290,abhinavgpt,4,0.00808,11898,24.02957,49514
291,AHB102,4,0.00808,11902,24.03765,49514
292,aldwnesx,4,0.00808,11906,24.04572,49514
293,andrewroblox,4,0.00808,11910,24.05380,49514
294,aodahl,4,0.00808,11914,24.06188,49514
295,bherta,4,0.00808,11918,24.06996,49514
296,chandra-siri,4,0.00808,11922,24.07804,49514
297,codinseok,4,0.00808,11926,24.08612,49514
298,cyzhzhd,4,0.00808,11930,24.09420,49514
299,DanielWhite95,4,0.00808,11934,24.10227,49514
300,danishsamad,4,0.00808,11938,24.11035,49514
301,DeepFlame-JR,4,0.00808,11942,24.11843,49514
302,DeeptanshuDas,4,0.00808,11946,24.12651,49514
303,dilverse,4,0.00808,11950,24.13459,49514
304,egvikosh,4,0.00808,11954,24.14267,49514
305,EmielStoelinga,4,0.00808,11958,24.15075,49514
306,funbiscuit,4,0.00808,11962,24.15882,49514
307,gfkeith,4,0.00808,11966,24.16690,49514
308,himanshu9345,4,0.00808,11970,24.17498,49514
309,jagan120,4,0.00808,11974,24.18306,49514
310,jmlaubach,4,0.00808,11978,24.19114,49514
311,johanek2,4,0.00808,11982,24.19922,49514
312,kolasanichaitanya,4,0.00808,11986,24.20729,49514
313,kpulipati,4,0.00808,11990,24.21537,49514
314,krazik-intuit,4,0.00808,11994,24.22345,49514
315,kylegc,4,0.00808,11998,24.23153,49514
316,lei1liu,4,0.00808,12002,24.23961,49514
317,Lejboelle,4,0.00808,12006,24.24769,49514
318,lre,4,0.00808,12010,24.25577,49514
319,mahsanaru,4,0.00808,12014,24.26384,49514
320,mcrisafu,4,0.00808,12018,24.27192,49514
321,mikekatana,4,0.00808,12022,24.28000,49514
322,Mrreboot7,4,0.00808,12026,24.28808,49514
323,MuhamedAyoub,4,0.00808,12030,24.29616,49514
324,mwaykole,4,0.00808,12034,24.30424,49514
325,neelasha-09,4,0.00808,12038,24.31232,49514
326,nirmesh,4,0.00808,12042,24.32039,49514
327,PiePra,4,0.00808,12046,24.32847,49514
328,portkey2112,4,0.00808,12050,24.33655,49514
329,pthalasta,4,0.00808,12054,24.34463,49514
330,quanguachong,4,0.00808,12058,24.35271,49514
331,scinerio,4,0.00808,12062,24.36079,49514
332,shrinivas1998,4,0.00808,12066,24.36887,49514
333,shubamsharma,4,0.00808,12070,24.37694,49514
334,sidharthkumarpradhan,4,0.00808,12074,24.38502,49514
335,smolendawid,4,0.00808,12078,24.39310,49514
336,sonu1311,4,0.00808,12082,24.40118,49514
337,sriharan16,4,0.00808,12086,24.40926,49514
338,ssilb4,4,0.00808,12090,24.41734,49514
339,TrevorM15,4,0.00808,12094,24.42542,49514
340,vanakema,4,0.00808,12098,24.43349,49514
341,wenyangzz,4,0.00808,12102,24.44157,49514
342,Yaoda77,4,0.00808,12106,24.44965,49514
343,yoshie-kosaka,4,0.00808,12110,24.45773,49514
344,yribeiro,4,0.00808,12114,24.46581,49514
345,zhangyue110026,4,0.00808,12118,24.47389,49514
346,ZhengJuCn,4,0.00808,12122,24.48196,49514
347,408410069,3,0.00606,12125,24.48802,49514
348,7sunarni,3,0.00606,12128,24.49408,49514
349,A923357,3,0.00606,12131,24.50014,49514
350,abdulvirta,3,0.00606,12134,24.50620,49514
351,acardoco,3,0.00606,12137,24.51226,49514
352,adamjablonowski,3,0.00606,12140,24.51832,49514
353,adrwong-lora,3,0.00606,12143,24.52438,49514
354,Aggiemaster,3,0.00606,12146,24.53044,49514
355,aitorhh,3,0.00606,12149,24.53649,49514
356,ajsalow,3,0.00606,12152,24.54255,49514
357,allilou,3,0.00606,12155,24.54861,49514
358,amine-lah,3,0.00606,12158,24.55467,49514
359,amir-hoseyn77,3,0.00606,12161,24.56073,49514
360,archywillhe,3,0.00606,12164,24.56679,49514
361,BakingBrains,3,0.00606,12167,24.57285,49514
362,batuhandoverIBM,3,0.00606,12170,24.57891,49514
363,beratturan,3,0.00606,12173,24.58497,49514
364,blue0229,3,0.00606,12176,24.59102,49514
365,cakeislife100,3,0.00606,12179,24.59708,49514
366,cdunklau-dt,3,0.00606,12182,24.60314,49514
367,cfloressuazo,3,0.00606,12185,24.60920,49514
368,chintha-v,3,0.00606,12188,24.61526,49514
369,chuasweechin,3,0.00606,12191,24.62132,49514
370,cjackal,3,0.00606,12194,24.62738,49514
371,Copilot,3,0.00606,12197,24.63344,49514
372,d0m3n1cc,3,0.00606,12200,24.63950,49514
373,daktang,3,0.00606,12203,24.64555,49514
374,dale1202,3,0.00606,12206,24.65161,49514
375,DanielTemesgen,3,0.00606,12209,24.65767,49514
376,delonleonard,3,0.00606,12212,24.66373,49514
377,deniyes,3,0.00606,12215,24.66979,49514
378,dsgibbons,3,0.00606,12218,24.67585,49514
379,dshen51,3,0.00606,12221,24.68191,49514
380,dtrawins,3,0.00606,12224,24.68797,49514
381,eric79,3,0.00606,12227,24.69403,49514
382,EyeCantCU,3,0.00606,12230,24.70008,49514
383,fcami,3,0.00606,12233,24.70614,49514
384,florian-koenig,3,0.00606,12236,24.71220,49514
385,frosk1,3,0.00606,12239,24.71826,49514
386,fschlz,3,0.00606,12242,24.72432,49514
387,Future-Outlier,3,0.00606,12245,24.73038,49514
388,genlu2011,3,0.00606,12248,24.73644,49514
389,geodavic,3,0.00606,12251,24.74250,49514
390,hahahannes,3,0.00606,12254,24.74856,49514
391,haksuuu,3,0.00606,12257,24.75461,49514
392,HamidShojanazeri,3,0.00606,12260,24.76067,49514
393,hifazibm,3,0.00606,12263,24.76673,49514
394,Hojland,3,0.00606,12266,24.77279,49514
395,hugcyrill,3,0.00606,12269,24.77885,49514
396,hutm,3,0.00606,12272,24.78491,49514
397,iamahern,3,0.00606,12275,24.79097,49514
398,Inkorak,3,0.00606,12278,24.79703,49514
399,iwyoo,3,0.00606,12281,24.80309,49514
400,jacoporadi,3,0.00606,12284,24.80914,49514
401,JakeTheWise,3,0.00606,12287,24.81520,49514
402,JaynouOliver,3,0.00606,12290,24.82126,49514
403,jefshe,3,0.00606,12293,24.82732,49514
404,JishnuM,3,0.00606,12296,24.83338,49514
405,KaiKustermann,3,0.00606,12299,24.83944,49514
406,KanwarGill811,3,0.00606,12302,24.84550,49514
407,KanwarpartapSingh,3,0.00606,12305,24.85156,49514
408,karolpustelnik,3,0.00606,12308,24.85762,49514
409,kenhktsui,3,0.00606,12311,24.86367,49514
410,kenwoodjw,3,0.00606,12314,24.86973,49514
411,kingjan1999,3,0.00606,12317,24.87579,49514
412,kmr0877,3,0.00606,12320,24.88185,49514
413,kruthikakr,3,0.00606,12323,24.88791,49514
414,kubbo,3,0.00606,12326,24.89397,49514
415,kwjerrychan,3,0.00606,12329,24.90003,49514
416,lamhoangtung,3,0.00606,12332,24.90609,49514
417,leecs0503,3,0.00606,12335,24.91215,49514
418,linuraj,3,0.00606,12338,24.91820,49514
419,liyinhgqw,3,0.00606,12341,24.92426,49514
420,ljainker,3,0.00606,12344,24.93032,49514
421,mafs12,3,0.00606,12347,24.93638,49514
422,marek-veber,3,0.00606,12350,24.94244,49514
423,mayankagarwal19911,3,0.00606,12353,24.94850,49514
424,medinad96,3,0.00606,12356,24.95456,49514
425,mgw2168-1,3,0.00606,12359,24.96062,49514
426,mhaas,3,0.00606,12362,24.96668,49514
427,MichaelXcc,3,0.00606,12365,24.97273,49514
428,michelverheijen,3,0.00606,12368,24.97879,49514
429,mikelam-us-aixplain,3,0.00606,12371,24.98485,49514
430,mlegore,3,0.00606,12374,24.99091,49514
431,mmg10,3,0.00606,12377,24.99697,49514
432,mojokb,3,0.00606,12380,25.00303,49514
433,mzhl1111,3,0.00606,12383,25.00909,49514
434,nashra2637,3,0.00606,12386,25.01515,49514
435,nosqlcoco,3,0.00606,12389,25.02121,49514
436,ofir-bt,3,0.00606,12392,25.02727,49514
437,paloma-rebuelta,3,0.00606,12395,25.03332,49514
438,pbasov,3,0.00606,12398,25.03938,49514
439,philipp1992,3,0.00606,12401,25.04544,49514
440,pkourouklidis,3,0.00606,12404,25.05150,49514
441,plainenough,3,0.00606,12407,25.05756,49514
442,pragadeeshraju,3,0.00606,12410,25.06362,49514
443,prashanthharshangi,3,0.00606,12413,25.06968,49514
444,praveeniitm,3,0.00606,12416,25.07574,49514
445,puneetsharma21,3,0.00606,12419,25.08180,49514
446,rahimftd,3,0.00606,12422,25.08785,49514
447,rajakavitha,3,0.00606,12425,25.09391,49514
448,raven-wing,3,0.00606,12428,25.09997,49514
449,r-matsuzaka,3,0.00606,12431,25.10603,49514
450,robbellMF,3,0.00606,12434,25.11209,49514
451,RohanGlitched,3,0.00606,12437,25.11815,49514
452,Rolleion,3,0.00606,12440,25.12421,49514
453,rvalkenaers,3,0.00606,12443,25.13027,49514
454,sachinlionel,3,0.00606,12446,25.13633,49514
455,Safarveisi,3,0.00606,12449,25.14238,49514
456,SagyHarpazGong,3,0.00606,12452,25.14844,49514
457,shashank3959,3,0.00606,12455,25.15450,49514
458,shawnL1225,3,0.00606,12458,25.16056,49514
459,sheromon,3,0.00606,12461,25.16662,49514
460,SiddharthPant,3,0.00606,12464,25.17268,49514
461,Sifat1998,3,0.00606,12467,25.17874,49514
462,soochem,3,0.00606,12470,25.18480,49514
463,studyingflying,3,0.00606,12473,25.19086,49514
464,Sundragon1993,3,0.00606,12476,25.19691,49514
465,tamis-laan,3,0.00606,12479,25.20297,49514
466,tarukumar,3,0.00606,12482,25.20903,49514
467,tdoublep,3,0.00606,12485,25.21509,49514
468,Thijsvandepoll,3,0.00606,12488,25.22115,49514
469,thomwatkin,3,0.00606,12491,25.22721,49514
470,todtjs92,3,0.00606,12494,25.23327,49514
471,trojaond,3,0.00606,12497,25.23933,49514
472,twtheisen,3,0.00606,12500,25.24539,49514
473,typhoonzero,3,0.00606,12503,25.25144,49514
474,udaij12,3,0.00606,12506,25.25750,49514
475,vdabravolski,3,0.00606,12509,25.26356,49514
476,vegoutha,3,0.00606,12512,25.26962,49514
477,VidhyaPandi,3,0.00606,12515,25.27568,49514
478,vignesh-murugani2i,3,0.00606,12518,25.28174,49514
479,vishal-kr-yadav,3,0.00606,12521,25.28780,49514
480,waleedqk,3,0.00606,12524,25.29386,49514
481,wassimMsw,3,0.00606,12527,25.29992,49514
482,wfg314,3,0.00606,12530,25.30597,49514
483,wlzzZ,3,0.00606,12533,25.31203,49514
484,wqlparallel,3,0.00606,12536,25.31809,49514
485,XiangFrank,3,0.00606,12539,25.32415,49514
486,yadavshashank,3,0.00606,12542,25.33021,49514
487,1eedaegon,2,0.00404,12544,25.33425,49514
488,1skol1,2,0.00404,12546,25.33829,49514
489,362728482,2,0.00404,12548,25.34233,49514
490,aba-ca-xi,2,0.00404,12550,25.34637,49514
491,abrarmajeedi,2,0.00404,12552,25.35041,49514
492,accraze,2,0.00404,12554,25.35445,49514
493,ace-gabriel,2,0.00404,12556,25.35848,49514
494,akakakakakaa,2,0.00404,12558,25.36252,49514
495,aka-toxa,2,0.00404,12560,25.36656,49514
496,akshaymittal143,2,0.00404,12562,25.37060,49514
497,akshhack,2,0.00404,12564,25.37464,49514
498,alexcoca,2,0.00404,12566,25.37868,49514
499,amir9ume,2,0.00404,12568,25.38272,49514
500,AndEsterson,2,0.00404,12570,25.38676,49514
501,andreeamun,2,0.00404,12572,25.39080,49514
502,andy-crai,2,0.00404,12574,25.39484,49514
503,ankurbaglodi,2,0.00404,12576,25.39888,49514
504,beyersito,2,0.00404,12578,25.40292,49514
505,Bhakti087,2,0.00404,12580,25.40696,49514
506,bharath0208,2,0.00404,12582,25.41099,49514
507,bhupc,2,0.00404,12584,25.41503,49514
508,bjmrevilla,2,0.00404,12586,25.41907,49514
509,BrandonLiang,2,0.00404,12588,25.42311,49514
510,brness,2,0.00404,12590,25.42715,49514
511,brooks-ulap,2,0.00404,12592,25.43119,49514
512,buluba89,2,0.00404,12594,25.43523,49514
513,bunyaminkeles,2,0.00404,12596,25.43927,49514
514,bwhartlove,2,0.00404,12598,25.44331,49514
515,caleygoff-invitae,2,0.00404,12600,25.44735,49514
516,cdmdc,2,0.00404,12602,25.45139,49514
517,Ce11an,2,0.00404,12604,25.45543,49514
518,cmward,2,0.00404,12606,25.45947,49514
519,coolchigi,2,0.00404,12608,25.46351,49514
520,cornleaf,2,0.00404,12610,25.46754,49514
521,CreatorSky,2,0.00404,12612,25.47158,49514
522,cryoff,2,0.00404,12614,25.47562,49514
523,D3f0,2,0.00404,12616,25.47966,49514
524,dafu-wu,2,0.00404,12618,25.48370,49514
525,danielrubin1989,2,0.00404,12620,25.48774,49514
526,dharkanpok,2,0.00404,12622,25.49178,49514
527,dhinasplace,2,0.00404,12624,25.49582,49514
528,diazidabagus,2,0.00404,12626,25.49986,49514
529,diya-18,2,0.00404,12628,25.50390,49514
530,dkondidatov,2,0.00404,12630,25.50794,49514
531,drassokhin,2,0.00404,12632,25.51198,49514
532,drew-two,2,0.00404,12634,25.51602,49514
533,DriverSong,2,0.00404,12636,25.52005,49514
534,Edwardsleo,2,0.00404,12638,25.52409,49514
535,elsud,2,0.00404,12640,25.52813,49514
536,EnyMan,2,0.00404,12642,25.53217,49514
537,evilr00t,2,0.00404,12644,25.53621,49514
538,f4hy,2,0.00404,12646,25.54025,49514
539,fabidick22,2,0.00404,12648,25.54429,49514
540,fishkerez,2,0.00404,12650,25.54833,49514
541,fj-ochiai,2,0.00404,12652,25.55237,49514
542,fstakem,2,0.00404,12654,25.55641,49514
543,Gaddy-BL,2,0.00404,12656,25.56045,49514
544,gilbeckers,2,0.00404,12658,25.56449,49514
545,Giles-Billenness,2,0.00404,12660,25.56853,49514
546,hardik-menger,2,0.00404,12662,25.57257,49514
547,harshyadav17,2,0.00404,12664,25.57660,49514
548,hellwigt-eq,2,0.00404,12666,25.58064,49514
549,hex2dec,2,0.00404,12668,25.58468,49514
550,heyselbi,2,0.00404,12670,25.58872,49514
551,hfeng101,2,0.00404,12672,25.59276,49514
552,hjweide,2,0.00404,12674,25.59680,49514
553,I321506,2,0.00404,12676,25.60084,49514
554,ian-beaver,2,0.00404,12678,25.60488,49514
555,InderjeetVishnoi,2,0.00404,12680,25.60892,49514
556,ishaan-mehta,2,0.00404,12682,25.61296,49514
557,jacksarle,2,0.00404,12684,25.61700,49514
558,jaeuHeo,2,0.00404,12686,25.62104,49514
559,jaffe-fly,2,0.00404,12688,25.62508,49514
560,james426759,2,0.00404,12690,25.62911,49514
561,jan-stanek,2,0.00404,12692,25.63315,49514
562,jeanbaptiste-brasselet,2,0.00404,12694,25.63719,49514
563,jeremy-london,2,0.00404,12696,25.64123,49514
564,jesusbasea,2,0.00404,12698,25.64527,49514
565,jfcortina,2,0.00404,12700,25.64931,49514
566,jgoodman8,2,0.00404,12702,25.65335,49514
567,jhs0318,2,0.00404,12704,25.65739,49514
568,jiaozhentian,2,0.00404,12706,25.66143,49514
569,jinoobaek-qz,2,0.00404,12708,25.66547,49514
570,jiujiang,2,0.00404,12710,25.66951,49514
571,joinal-ahmed,2,0.00404,12712,25.67355,49514
572,JoinHands,2,0.00404,12714,25.67759,49514
573,JoseeePZ,2,0.00404,12716,25.68163,49514
574,jvujjini,2,0.00404,12718,25.68566,49514
575,jzonthemtn,2,0.00404,12720,25.68970,49514
576,KageRyo,2,0.00404,12722,25.69374,49514
577,Klein-Hu,2,0.00404,12724,25.69778,49514
578,koenmtb1,2,0.00404,12726,25.70182,49514
579,kpeters,2,0.00404,12728,25.70586,49514
580,lamoghaighoroje,2,0.00404,12730,25.70990,49514
581,laurentgrangeau,2,0.00404,12732,25.71394,49514
582,lc2a,2,0.00404,12734,25.71798,49514
583,liaspas,2,0.00404,12736,25.72202,49514
584,Liujunhao123,2,0.00404,12738,25.72606,49514
585,livneros,2,0.00404,12740,25.73010,49514
586,lklkxcxc,2,0.00404,12742,25.73414,49514
587,Lolologist,2,0.00404,12744,25.73818,49514
588,ls-2018,2,0.00404,12746,25.74221,49514
589,m1ghtym0,2,0.00404,12748,25.74625,49514
590,majolo,2,0.00404,12750,25.75029,49514
591,marcjimz,2,0.00404,12752,25.75433,49514
592,MarcosRiveraMartinez,2,0.00404,12754,25.75837,49514
593,MarshHawk,2,0.00404,12756,25.76241,49514
594,mgumowsk,2,0.00404,12758,25.76645,49514
595,michaeltinsley,2,0.00404,12760,25.77049,49514
596,MimeZoe0628,2,0.00404,12762,25.77453,49514
597,mjf-89,2,0.00404,12764,25.77857,49514
598,mrudulan,2,0.00404,12766,25.78261,49514
599,murata-yu,2,0.00404,12768,25.78665,49514
600,muthuraj-i2i,2,0.00404,12770,25.79069,49514
601,Nabsku,2,0.00404,12772,25.79472,49514
602,namlh16,2,0.00404,12774,25.79876,49514
603,NandiniNagothu,2,0.00404,12776,25.80280,49514
604,nirmdesai,2,0.00404,12778,25.80684,49514
605,nkamath5,2,0.00404,12780,25.81088,49514
606,nnshah1,2,0.00404,12782,25.81492,49514
607,noymmm,2,0.00404,12784,25.81896,49514
608,nphilou,2,0.00404,12786,25.82300,49514
609,OfTheThorn,2,0.00404,12788,25.82704,49514
610,pablocael,2,0.00404,12790,25.83108,49514
611,pheianox,2,0.00404,12792,25.83512,49514
612,phonaylin,2,0.00404,12794,25.83916,49514
613,pmcfadin,2,0.00404,12796,25.84320,49514
614,pratikgujjar,2,0.00404,12798,25.84724,49514
615,prem0912,2,0.00404,12800,25.85127,49514
616,pshegde,2,0.00404,12802,25.85531,49514
617,pufinbruun,2,0.00404,12804,25.85935,49514
618,radcheb,2,0.00404,12806,25.86339,49514
619,rajeshdhanda,2,0.00404,12808,25.86743,49514
620,rlatjswlr123,2,0.00404,12810,25.87147,49514
621,robinvd,2,0.00404,12812,25.87551,49514
622,RyanRennCN,2,0.00404,12814,25.87955,49514
623,sagarnildass,2,0.00404,12816,25.88359,49514
624,saintnoah,2,0.00404,12818,25.88763,49514
625,saphire001,2,0.00404,12820,25.89167,49514
626,Sathvik777,2,0.00404,12822,25.89571,49514
627,Sayed-Imran,2,0.00404,12824,25.89975,49514
628,seBasKov,2,0.00404,12826,25.90378,49514
629,serdar-akyol,2,0.00404,12828,25.90782,49514
630,seunggihong,2,0.00404,12830,25.91186,49514
631,sharm294,2,0.00404,12832,25.91590,49514
632,shauryagoel,2,0.00404,12834,25.91994,49514
633,shazinahmed,2,0.00404,12836,25.92398,49514
634,sheep94lion,2,0.00404,12838,25.92802,49514
635,shizy818,2,0.00404,12840,25.93206,49514
636,sholsapp,2,0.00404,12842,25.93610,49514
637,siva2k16,2,0.00404,12844,25.94014,49514
638,Sliceco,2,0.00404,12846,25.94418,49514
639,smandrell-ec,2,0.00404,12848,25.94822,49514
640,smkim17,2,0.00404,12850,25.95226,49514
641,spolloni,2,0.00404,12852,25.95630,49514
642,Sriharan-Manogaran,2,0.00404,12854,25.96033,49514
643,sshort,2,0.00404,12856,25.96437,49514
644,susan-shu-c,2,0.00404,12858,25.96841,49514
645,SZ789,2,0.00404,12860,25.97245,49514
646,TahirHayat,2,0.00404,12862,25.97649,49514
647,talk2jaydip,2,0.00404,12864,25.98053,49514
648,taylanates24,2,0.00404,12866,25.98457,49514
649,thomas-vanderwal,2,0.00404,12868,25.98861,49514
650,tidunguyen,2,0.00404,12870,25.99265,49514
651,Tiegris,2,0.00404,12872,25.99669,49514
652,tikr7,2,0.00404,12874,26.00073,49514
653,tkrober,2,0.00404,12876,26.00477,49514
654,tuan-ff,2,0.00404,12878,26.00881,49514
655,tulsi0523,2,0.00404,12880,26.01284,49514
656,twandja,2,0.00404,12882,26.01688,49514
657,tylerhyang-cloudera,2,0.00404,12884,26.02092,49514
658,veramonteiro1,2,0.00404,12886,26.02496,49514
659,vinayK34,2,0.00404,12888,26.02900,49514
660,vinismarques,2,0.00404,12890,26.03304,49514
661,VishnuJG,2,0.00404,12892,26.03708,49514
662,vvnpan,2,0.00404,12894,26.04112,49514
663,wDevil,2,0.00404,12896,26.04516,49514
664,wfangchi,2,0.00404,12898,26.04920,49514
665,will-gerard,2,0.00404,12900,26.05324,49514
666,wuyexixi,2,0.00404,12902,26.05728,49514
667,xfzhang1974,2,0.00404,12904,26.06132,49514
668,yashprakashsharma,2,0.00404,12906,26.06536,49514
669,YehCC52,2,0.00404,12908,26.06939,49514
670,yk4r2,2,0.00404,12910,26.07343,49514
671,zamamohx,2,0.00404,12912,26.07747,49514
672,zenglw06,2,0.00404,12914,26.08151,49514
673,zhihangdeng,2,0.00404,12916,26.08555,49514
674,zhouxinlun,2,0.00404,12918,26.08959,49514
675,zwong91,2,0.00404,12920,26.09363,49514
676,112358fn,1,0.00202,12921,26.09565,49514
677,12DReflections,1,0.00202,12922,26.09767,49514
678,14sudharsan,1,0.00202,12923,26.09969,49514
679,20joseph10,1,0.00202,12924,26.10171,49514
680,4vik,1,0.00202,12925,26.10373,49514
681,aartisinghh,1,0.00202,12926,26.10575,49514
682,abailie3,1,0.00202,12927,26.10777,49514
683,abhicodes369,1,0.00202,12928,26.10979,49514
684,AbhiDub,1,0.00202,12929,26.11181,49514
685,abhinonymous,1,0.00202,12930,26.11383,49514
686,achilles0x,1,0.00202,12931,26.11585,49514
687,adgaultier,1,0.00202,12932,26.11787,49514
688,adjordan,1,0.00202,12933,26.11989,49514
689,ageyuri,1,0.00202,12934,26.12190,49514
690,agunapal,1,0.00202,12935,26.12392,49514
691,ahsan-n,1,0.00202,12936,26.12594,49514
692,ainnedge,1,0.00202,12937,26.12796,49514
693,aishwary09,1,0.00202,12938,26.12998,49514
694,ajaen4,1,0.00202,12939,26.13200,49514
695,ajithkj,1,0.00202,12940,26.13402,49514
696,akravacyber,1,0.00202,12941,26.13604,49514
697,akshatgit,1,0.00202,12942,26.13806,49514
698,Al4DIN,1,0.00202,12943,26.14008,49514
699,AlessandroColantonio,1,0.00202,12944,26.14210,49514
700,AlexanderSing,1,0.00202,12945,26.14412,49514
701,alexandrerfischer,1,0.00202,12946,26.14614,49514
702,Alexejklim,1,0.00202,12947,26.14816,49514
703,alexeygrigorev,1,0.00202,12948,26.15018,49514
704,alexw994,1,0.00202,12949,26.15220,49514
705,amercier-twt,1,0.00202,12950,26.15422,49514
706,amitchnick,1,0.00202,12951,26.15624,49514
707,amnescher,1,0.00202,12952,26.15826,49514
708,AndreaCorda01,1,0.00202,12953,26.16028,49514
709,arya-oss,1,0.00202,12954,26.16230,49514
710,asdfsx,1,0.00202,12955,26.16432,49514
711,ashujain2,1,0.00202,12956,26.16634,49514
712,ashvinmoro,1,0.00202,12957,26.16836,49514
713,ask664,1,0.00202,12958,26.17038,49514
714,atinary-mguarinos,1,0.00202,12959,26.17240,49514
715,Atul-Anand-Jha,1,0.00202,12960,26.17442,49514
716,averagua,1,0.00202,12961,26.17643,49514
717,bansal01yash,1,0.00202,12962,26.17845,49514
718,BasakUlker,1,0.00202,12963,26.18047,49514
719,basildevops,1,0.00202,12964,26.18249,49514
720,baycarbone,1,0.00202,12965,26.18451,49514
721,bbk62,1,0.00202,12966,26.18653,49514
722,bcvanmeurs,1,0.00202,12967,26.18855,49514
723,beberg,1,0.00202,12968,26.19057,49514
724,bet0x,1,0.00202,12969,26.19259,49514
725,bgalvao,1,0.00202,12970,26.19461,49514
726,bhavana3,1,0.00202,12971,26.19663,49514
727,bitcqs,1,0.00202,12972,26.19865,49514
728,blakehawkins,1,0.00202,12973,26.20067,49514
729,bluayer,1,0.00202,12974,26.20269,49514
730,boringbyte,1,0.00202,12975,26.20471,49514
731,boris-toninski,1,0.00202,12976,26.20673,49514
732,boris-toninski-prime,1,0.00202,12977,26.20875,49514
733,BosiDC,1,0.00202,12978,26.21077,49514
734,bretello,1,0.00202,12979,26.21279,49514
735,brianmoran,1,0.00202,12980,26.21481,49514
736,caiyuanji,1,0.00202,12981,26.21683,49514
737,Calcagiara,1,0.00202,12982,26.21885,49514
738,CanmingCobble,1,0.00202,12983,26.22087,49514
739,cbalbera,1,0.00202,12984,26.22289,49514
740,c-brugo,1,0.00202,12985,26.22491,49514
741,cezhang,1,0.00202,12986,26.22693,49514
742,changhyuni,1,0.00202,12987,26.22895,49514
743,chanyou,1,0.00202,12988,26.23096,49514
744,charlieye-dev,1,0.00202,12989,26.23298,49514
745,cheng8994,1,0.00202,12990,26.23500,49514
746,chengsky-NTU,1,0.00202,12991,26.23702,49514
747,Chengyunlai,1,0.00202,12992,26.23904,49514
748,chrisalbon,1,0.00202,12993,26.24106,49514
749,chris-zen,1,0.00202,12994,26.24308,49514
750,cjxnn,1,0.00202,12995,26.24510,49514
751,cjxnn2,1,0.00202,12996,26.24712,49514
752,cloudbow,1,0.00202,12997,26.24914,49514
753,cnhbliyou,1,0.00202,12998,26.25116,49514
754,coalindiax,1,0.00202,12999,26.25318,49514
755,CodeSmileBot,1,0.00202,13000,26.25520,49514
756,ConverJens,1,0.00202,13001,26.25722,49514
757,CriGiu,1,0.00202,13002,26.25924,49514
758,Csehpi,1,0.00202,13003,26.26126,49514
759,danielmhair,1,0.00202,13004,26.26328,49514
760,DaoDaoNoCode,1,0.00202,13005,26.26530,49514
761,darwich6,1,0.00202,13006,26.26732,49514
762,dasydong,1,0.00202,13007,26.26934,49514
763,davekpatrick,1,0.00202,13008,26.27136,49514
764,davidvanrooij,1,0.00202,13009,26.27338,49514
765,davidyuyuan,1,0.00202,13010,26.27540,49514
766,daw3rd,1,0.00202,13011,26.27742,49514
767,dejangolubovic,1,0.00202,13012,26.27944,49514
768,deleeuwblue,1,0.00202,13013,26.28146,49514
769,DerTiedemann,1,0.00202,13014,26.28348,49514
770,dhanisahu,1,0.00202,13015,26.28550,49514
771,DhavalRepo18,1,0.00202,13016,26.28751,49514
772,didier-viboo,1,0.00202,13017,26.28953,49514
773,dilipgb,1,0.00202,13018,26.29155,49514
774,DineshKrishnanG,1,0.00202,13019,26.29357,49514
775,divyaprabha123,1,0.00202,13020,26.29559,49514
776,dnesting,1,0.00202,13021,26.29761,49514
777,dohrn,1,0.00202,13022,26.29963,49514
778,dommgifer,1,0.00202,13023,26.30165,49514
779,DorotheaKal,1,0.00202,13024,26.30367,49514
780,dulacp,1,0.00202,13025,26.30569,49514
781,ebachle,1,0.00202,13026,26.30771,49514
782,E-EE-E,1,0.00202,13027,26.30973,49514
783,EeroEternal,1,0.00202,13028,26.31175,49514
784,ElliottMoos,1,0.00202,13029,26.31377,49514
785,empath-nirvana,1,0.00202,13030,26.31579,49514
786,Erouan50,1,0.00202,13031,26.31781,49514
787,Everlasting-Elysium,1,0.00202,13032,26.31983,49514
788,ewasserman,1,0.00202,13033,26.32185,49514
789,exitflynn,1,0.00202,13034,26.32387,49514
790,fakeburst,1,0.00202,13035,26.32589,49514
791,felix-exel,1,0.00202,13036,26.32791,49514
792,fivemtebex,1,0.00202,13037,26.32993,49514
793,flopach,1,0.00202,13038,26.33195,49514
794,flybywind,1,0.00202,13039,26.33397,49514
795,Focke-Wulf,1,0.00202,13040,26.33599,49514
796,fOO223Fr,1,0.00202,13041,26.33801,49514
797,fooozhe,1,0.00202,13042,26.34003,49514
798,franexmo81,1,0.00202,13043,26.34204,49514
799,fredchen2022,1,0.00202,13044,26.34406,49514
800,Freedom-JJ,1,0.00202,13045,26.34608,49514
801,gandharv-kapoor,1,0.00202,13046,26.34810,49514
802,gdagil,1,0.00202,13047,26.35012,49514
803,gkumbhat,1,0.00202,13048,26.35214,49514
804,GodTamIt,1,0.00202,13049,26.35416,49514
805,gradjitta,1,0.00202,13050,26.35618,49514
806,gringParis,1,0.00202,13051,26.35820,49514
807,Haibread,1,0.00202,13052,26.36022,49514
808,HakkyuKim,1,0.00202,13053,26.36224,49514
809,harmeet-singh-discovery,1,0.00202,13054,26.36426,49514
810,harperjuanl,1,0.00202,13055,26.36628,49514
811,harshita-meena,1,0.00202,13056,26.36830,49514
812,HassaanAkbar,1,0.00202,13057,26.37032,49514
813,Hayyk,1,0.00202,13058,26.37234,49514
814,hemeimei,1,0.00202,13059,26.37436,49514
815,HenrryVargas,1,0.00202,13060,26.37638,49514
816,heqinw,1,0.00202,13061,26.37840,49514
817,hetorant,1,0.00202,13062,26.38042,49514
818,himanshumps,1,0.00202,13063,26.38244,49514
819,holyjackaiforia,1,0.00202,13064,26.38446,49514
820,homfen,1,0.00202,13065,26.38648,49514
821,howespt,1,0.00202,13066,26.38850,49514
822,HrushikeshGowda,1,0.00202,13067,26.39052,49514
823,hsouth95,1,0.00202,13068,26.39254,49514
824,hsteude,1,0.00202,13069,26.39456,49514
825,hvanu,1,0.00202,13070,26.39657,49514
826,HyeongminMoon,1,0.00202,13071,26.39859,49514
827,hyeongwooo,1,0.00202,13072,26.40061,49514
828,ichbinjakes,1,0.00202,13073,26.40263,49514
829,innovation-derby,1,0.00202,13074,26.40465,49514
830,ishaan-jaff,1,0.00202,13075,26.40667,49514
831,ja06200,1,0.00202,13076,26.40869,49514
832,jack-lio,1,0.00202,13077,26.41071,49514
833,jagveers,1,0.00202,13078,26.41273,49514
834,jakob-ed,1,0.00202,13079,26.41475,49514
835,janekmichalik,1,0.00202,13080,26.41677,49514
836,javen218,1,0.00202,13081,26.41879,49514
837,JayDoubleu,1,0.00202,13082,26.42081,49514
838,Jenya95,1,0.00202,13083,26.42283,49514
839,JeroenPeterBos,1,0.00202,13084,26.42485,49514
840,jerrygb,1,0.00202,13085,26.42687,49514
841,jiangxiaobin96,1,0.00202,13086,26.42889,49514
842,jiawenovo,1,0.00202,13087,26.43091,49514
843,JimBeam2019,1,0.00202,13088,26.43293,49514
844,jimknochelmann,1,0.00202,13089,26.43495,49514
845,jisd2089,1,0.00202,13090,26.43697,49514
846,jklaise,1,0.00202,13091,26.43899,49514
847,jkoessle,1,0.00202,13092,26.44101,49514
848,jkwak3,1,0.00202,13093,26.44303,49514
849,jmas77,1,0.00202,13094,26.44505,49514
850,john-daciuk,1,0.00202,13095,26.44707,49514
851,johnpaulett,1,0.00202,13096,26.44909,49514
852,jokerwyt,1,0.00202,13097,26.45110,49514
853,JonasTischer,1,0.00202,13098,26.45312,49514
854,Joostrothweiler,1,0.00202,13099,26.45514,49514
855,josete89,1,0.00202,13100,26.45716,49514
856,joshyjoseph,1,0.00202,13101,26.45918,49514
857,jotamartos,1,0.00202,13102,26.46120,49514
858,jsitu777,1,0.00202,13103,26.46322,49514
859,jssnirmal,1,0.00202,13104,26.46524,49514
860,juaggmv,1,0.00202,13105,26.46726,49514
861,juanma9613,1,0.00202,13106,26.46928,49514
862,julianmack,1,0.00202,13107,26.47130,49514
863,JustRedneval,1,0.00202,13108,26.47332,49514
864,juyunsang,1,0.00202,13109,26.47534,49514
865,jwkim912,1,0.00202,13110,26.47736,49514
866,ka2222222,1,0.00202,13111,26.47938,49514
867,kalantar,1,0.00202,13112,26.48140,49514
868,kdecyllene,1,0.00202,13113,26.48342,49514
869,KillianGolds,1,0.00202,13114,26.48544,49514
870,kjoth,1,0.00202,13115,26.48746,49514
871,klee989,1,0.00202,13116,26.48948,49514
872,klmkrishna,1,0.00202,13117,26.49150,49514
873,kmathiou,1,0.00202,13118,26.49352,49514
874,koga1694,1,0.00202,13119,26.49554,49514
875,kozzza,1,0.00202,13120,26.49756,49514
876,kromanow94,1,0.00202,13121,26.49958,49514
877,KrystianKoziel,1,0.00202,13122,26.50160,49514
878,ksdeekshith,1,0.00202,13123,26.50362,49514
879,kuanchoulai10,1,0.00202,13124,26.50563,49514
880,KunWang123,1,0.00202,13125,26.50765,49514
881,kvangundy,1,0.00202,13126,26.50967,49514
882,kwanwoo02,1,0.00202,13127,26.51169,49514
883,kwould,1,0.00202,13128,26.51371,49514
884,kyriakost,1,0.00202,13129,26.51573,49514
885,kyue1005,1,0.00202,13130,26.51775,49514
886,kz3640,1,0.00202,13131,26.51977,49514
887,langong347,1,0.00202,13132,26.52179,49514
888,LeBaronDean,1,0.00202,13133,26.52381,49514
889,Lee-Albert,1,0.00202,13134,26.52583,49514
890,lethnis,1,0.00202,13135,26.52785,49514
891,lewj85,1,0.00202,13136,26.52987,49514
892,lileilai,1,0.00202,13137,26.53189,49514
893,ljtruong,1,0.00202,13138,26.53391,49514
894,lnguyen46,1,0.00202,13139,26.53593,49514
895,lurecas,1,0.00202,13140,26.53795,49514
896,LvWuqian,1,0.00202,13141,26.53997,49514
897,mahdikhashan,1,0.00202,13142,26.54199,49514
898,majorinche,1,0.00202,13143,26.54401,49514
899,mangalaman93,1,0.00202,13144,26.54603,49514
900,manpreet-ml,1,0.00202,13145,26.54805,49514
901,mansi104-ai,1,0.00202,13146,26.55007,49514
902,marcinkosztolowiczrasp,1,0.00202,13147,26.55209,49514
903,MarcoLuw,1,0.00202,13148,26.55411,49514
904,mary26pz,1,0.00202,13149,26.55613,49514
905,mattjohnsonpint,1,0.00202,13150,26.55815,49514
906,maxqlord,1,0.00202,13151,26.56016,49514
907,MaxZhuravsky,1,0.00202,13152,26.56218,49514
908,Mayurji,1,0.00202,13153,26.56420,49514
909,Mehrad0711,1,0.00202,13154,26.56622,49514
910,melonious,1,0.00202,13155,26.56824,49514
911,MenD32,1,0.00202,13156,26.57026,49514
912,mengal12,1,0.00202,13157,26.57228,49514
913,mexeniz,1,0.00202,13158,26.57430,49514
914,mginfn,1,0.00202,13159,26.57632,49514
915,mihow,1,0.00202,13160,26.57834,49514
916,MikeRiz521,1,0.00202,13161,26.58036,49514
917,min731,1,0.00202,13162,26.58238,49514
918,ming-afk,1,0.00202,13163,26.58440,49514
919,ml-lubich,1,0.00202,13164,26.58642,49514
920,mmoreiradj,1,0.00202,13165,26.58844,49514
921,m-nml,1,0.00202,13166,26.59046,49514
922,mohakamg,1,0.00202,13167,26.59248,49514
923,morningcafe,1,0.00202,13168,26.59450,49514
924,moseoh,1,0.00202,13169,26.59652,49514
925,MrMegaMango,1,0.00202,13170,26.59854,49514
926,msalehiNV,1,0.00202,13171,26.60056,49514
927,MSKazemi,1,0.00202,13172,26.60258,49514
928,msradam,1,0.00202,13173,26.60460,49514
929,msyulia,1,0.00202,13174,26.60662,49514
930,mtoslalibu,1,0.00202,13175,26.60864,49514
931,mudhakar,1,0.00202,13176,26.61066,49514
932,murat-gunay,1,0.00202,13177,26.61268,49514
933,muzhi1991,1,0.00202,13178,26.61469,49514
934,mwm5945,1,0.00202,13179,26.61671,49514
935,mzegla,1,0.00202,13180,26.61873,49514
936,namirinz,1,0.00202,13181,26.62075,49514
937,narfian,1,0.00202,13182,26.62277,49514
938,nathanbowness,1,0.00202,13183,26.62479,49514
939,naveeniyengar,1,0.00202,13184,26.62681,49514
940,nchukkaio,1,0.00202,13185,26.62883,49514
941,nc-sika,1,0.00202,13186,26.63085,49514
942,neha013,1,0.00202,13187,26.63287,49514
943,nhn-juhyeon,1,0.00202,13188,26.63489,49514
944,nieksand,1,0.00202,13189,26.63691,49514
945,Nisarg-18,1,0.00202,13190,26.63893,49514
946,nlin-kobold,1,0.00202,13191,26.64095,49514
947,nm2107,1,0.00202,13192,26.64297,49514
948,nmkrishna,1,0.00202,13193,26.64499,49514
949,noelo,1,0.00202,13194,26.64701,49514
950,NonStatic2014,1,0.00202,13195,26.64903,49514
951,npapapietro,1,0.00202,13196,26.65105,49514
952,ns-jman,1,0.00202,13197,26.65307,49514
953,nyejon,1,0.00202,13198,26.65509,49514
954,oadams,1,0.00202,13199,26.65711,49514
955,OBubbleO,1,0.00202,13200,26.65913,49514
956,odaysec,1,0.00202,13201,26.66115,49514
957,ofey404,1,0.00202,13202,26.66317,49514
958,oguzhanoyan,1,0.00202,13203,26.66519,49514
959,oha95,1,0.00202,13204,26.66721,49514
960,oldrich-safar,1,0.00202,13205,26.66922,49514
961,omarcevi,1,0.00202,13206,26.67124,49514
962,osaia-js,1,0.00202,13207,26.67326,49514
963,panli889,1,0.00202,13208,26.67528,49514
964,Paperone80,1,0.00202,13209,26.67730,49514
965,parano,1,0.00202,13210,26.67932,49514
966,parthasarathi-pm,1,0.00202,13211,26.68134,49514
967,pavanchhatpar,1,0.00202,13212,26.68336,49514
968,pcdas,1,0.00202,13213,26.68538,49514
969,pencilerazzer,1,0.00202,13214,26.68740,49514
970,phutaneVinayak,1,0.00202,13215,26.68942,49514
971,piaobeizu,1,0.00202,13216,26.69144,49514
972,planetA,1,0.00202,13217,26.69346,49514
973,plankthom,1,0.00202,13218,26.69548,49514
974,planning018,1,0.00202,13219,26.69750,49514
975,prakashsingh21,1,0.00202,13220,26.69952,49514
976,pszzz,1,0.00202,13221,26.70154,49514
977,qinxuye,1,0.00202,13222,26.70356,49514
978,Qsgz2023ji5ban,1,0.00202,13223,26.70558,49514
979,QuadTriangle,1,0.00202,13224,26.70760,49514
980,raahulraa,1,0.00202,13225,26.70962,49514
981,Radwan-Ibrahim,1,0.00202,13226,26.71164,49514
982,Raghul-M,1,0.00202,13227,26.71366,49514
983,rajendra-t,1,0.00202,13228,26.71568,49514
984,rakshithvsk,1,0.00202,13229,26.71770,49514
985,ram4444,1,0.00202,13230,26.71972,49514
986,rasnarams,1,0.00202,13231,26.72174,49514
987,ratovarius,1,0.00202,13232,26.72375,49514
988,red8888,1,0.00202,13233,26.72577,49514
989,renenxie,1,0.00202,13234,26.72779,49514
990,RezaSR,1,0.00202,13235,26.72981,49514
991,ric-art-m,1,0.00202,13236,26.73183,49514
992,rileygreen022,1,0.00202,13237,26.73385,49514
993,rky0930,1,0.00202,13238,26.73587,49514
994,Rogerwyf,1,0.00202,13239,26.73789,49514
995,rohanarora,1,0.00202,13240,26.73991,49514
996,Rory602,1,0.00202,13241,26.74193,49514
997,rosemorozenkova,1,0.00202,13242,26.74395,49514
998,rossbrigoli,1,0.00202,13243,26.74597,49514
999,RUOK90,1,0.00202,13244,26.74799,49514
1000,Ryojikn,1,0.00202,13245,26.75001,49514
1001,sagi-shimoni,1,0.00202,13246,26.75203,49514
1002,SaiKireeti2905,1,0.00202,13247,26.75405,49514
1003,saisowjanyab,1,0.00202,13248,26.75607,49514
1004,Samjoel3101,1,0.00202,13249,26.75809,49514
1005,Sangauppe,1,0.00202,13250,26.76011,49514
1006,SANJAY-NT,1,0.00202,13251,26.76213,49514
1007,scottclusk,1,0.00202,13252,26.76415,49514
1008,SDJustus,1,0.00202,13253,26.76617,49514
1009,seankst,1,0.00202,13254,26.76819,49514
1010,seeking-dev,1,0.00202,13255,26.77021,49514
1011,seth-zou,1,0.00202,13256,26.77223,49514
1012,Shai1-Levi,1,0.00202,13257,26.77425,49514
1013,shakteebiswal,1,0.00202,13258,26.77627,49514
1014,shaozhijian2008,1,0.00202,13259,26.77828,49514
1015,sharonliu-gfg,1,0.00202,13260,26.78030,49514
1016,SHAZFA565,1,0.00202,13261,26.78232,49514
1017,shijunx,1,0.00202,13262,26.78434,49514
1018,shubhamrai1993,1,0.00202,13263,26.78636,49514
1019,sidharth-pradhan-github,1,0.00202,13264,26.78838,49514
1020,silverlining21,1,0.00202,13265,26.79040,49514
1021,Sinba7,1,0.00202,13266,26.79242,49514
1022,skel84,1,0.00202,13267,26.79444,49514
1023,skseo941229,1,0.00202,13268,26.79646,49514
1024,skytodmoon,1,0.00202,13269,26.79848,49514
1025,SlavaNL,1,0.00202,13270,26.80050,49514
1026,sliat3pm,1,0.00202,13271,26.80252,49514
1027,slik13,1,0.00202,13272,26.80454,49514
1028,slitery1234,1,0.00202,13273,26.80656,49514
1029,sml0820,1,0.00202,13274,26.80858,49514
1030,snowmanbamm,1,0.00202,13275,26.81060,49514
1031,spacew,1,0.00202,13276,26.81262,49514
1032,spoonysnail,1,0.00202,13277,26.81464,49514
1033,sreddybr3,1,0.00202,13278,26.81666,49514
1034,srishti0190,1,0.00202,13279,26.81868,49514
1035,ssamora,1,0.00202,13280,26.82070,49514
1036,sshakeri,1,0.00202,13281,26.82272,49514
1037,Stannislav,1,0.00202,13282,26.82474,49514
1038,StateGovernment,1,0.00202,13283,26.82676,49514
1039,stomplee,1,0.00202,13284,26.82878,49514
1040,stradigi-andres-de-castro,1,0.00202,13285,26.83080,49514
1041,Strasser-Pablo,1,0.00202,13286,26.83281,49514
1042,streetbaby,1,0.00202,13287,26.83483,49514
1043,suhaskashyapr,1,0.00202,13288,26.83685,49514
1044,sumiahsan06,1,0.00202,13289,26.83887,49514
1045,sunandosamaddar,1,0.00202,13290,26.84089,49514
1046,superlins,1,0.00202,13291,26.84291,49514
1047,swartz-k,1,0.00202,13292,26.84493,49514
1048,swith005,1,0.00202,13293,26.84695,49514
1049,T3ssa,1,0.00202,13294,26.84897,49514
1050,talexander,1,0.00202,13295,26.85099,49514
1051,tama-biro,1,0.00202,13296,26.85301,49514
1052,Tamannaverma1912,1,0.00202,13297,26.85503,49514
1053,tanmayv25,1,0.00202,13298,26.85705,49514
1054,tarunsk1998,1,0.00202,13299,26.85907,49514
1055,tbogdal,1,0.00202,13300,26.86109,49514
1056,tc360950,1,0.00202,13301,26.86311,49514
1057,tejashpe,1,0.00202,13302,26.86513,49514
1058,Tengxu666,1,0.00202,13303,26.86715,49514
1059,Terpaksa2,1,0.00202,13304,26.86917,49514
1060,teynar,1,0.00202,13305,26.87119,49514
1061,tguner-arteriaai,1,0.00202,13306,26.87321,49514
1062,thecloudgarage,1,0.00202,13307,26.87523,49514
1063,TheConstant3,1,0.00202,13308,26.87725,49514
1064,thoo,1,0.00202,13309,26.87927,49514
1065,tonywang-sh,1,0.00202,13310,26.88129,49514
1066,u6yuvi,1,0.00202,13311,26.88331,49514
1067,ultrons,1,0.00202,13312,26.88533,49514
1068,UnprofessinalCreator,1,0.00202,13313,26.88734,49514
1069,uraychang,1,0.00202,13314,26.88936,49514
1070,vadivelg,1,0.00202,13315,26.89138,49514
1071,Vafilor,1,0.00202,13316,26.89340,49514
1072,VAveryanov8,1,0.00202,13317,26.89542,49514
1073,vdanyliv,1,0.00202,13318,26.89744,49514
1074,venkat-ravilla,1,0.00202,13319,26.89946,49514
1075,vimal701,1,0.00202,13320,26.90148,49514
1076,vinoth-gojek,1,0.00202,13321,26.90350,49514
1077,vladimirtiukhtin,1,0.00202,13322,26.90552,49514
1078,vmalaga,1,0.00202,13323,26.90754,49514
1079,vsivaraja,1,0.00202,13324,26.90956,49514
1080,Waqas-Shah-42,1,0.00202,13325,26.91158,49514
1081,weskerfoot,1,0.00202,13326,26.91360,49514
1082,whoisltd,1,0.00202,13327,26.91562,49514
1083,WinsonSou,1,0.00202,13328,26.91764,49514
1084,wjp-cn,1,0.00202,13329,26.91966,49514
1085,WograTimKoehler,1,0.00202,13330,26.92168,49514
1086,woop,1,0.00202,13331,26.92370,49514
1087,wphicks,1,0.00202,13332,26.92572,49514
1088,xiaoToby,1,0.00202,13333,26.92774,49514
1089,xuyongpku,1,0.00202,13334,26.92976,49514
1090,xybuty,1,0.00202,13335,26.93178,49514
1091,Yael-F,1,0.00202,13336,26.93380,49514
1092,yage11,1,0.00202,13337,26.93582,49514
1093,yanfeng-li,1,0.00202,13338,26.93784,49514
1094,yang-ewx,1,0.00202,13339,26.93986,49514
1095,yannick-roeder,1,0.00202,13340,26.94188,49514
1096,yecohn,1,0.00202,13341,26.94389,49514
1097,yigitsoy,1,0.00202,13342,26.94591,49514
1098,YishuiLi,1,0.00202,13343,26.94793,49514
1099,yliu989,1,0.00202,13344,26.94995,49514
1100,Yokesh-RS,1,0.00202,13345,26.95197,49514
1101,Youngwoo-git,1,0.00202,13346,26.95399,49514
1102,youxingtian,1,0.00202,13347,26.95601,49514
1103,yuanbai,1,0.00202,13348,26.95803,49514
1104,yunchen625,1,0.00202,13349,26.96005,49514
1105,zachsmith1,1,0.00202,13350,26.96207,49514
1106,zhangle-dev,1,0.00202,13351,26.96409,49514
1107,zhou-harry,1,0.00202,13352,26.96611,49514
1108,zoramthanga,1,0.00202,13353,26.96813,49514
1109,zsr228,1,0.00202,13354,26.97015,49514
1110,zzr93,1,0.00202,13355,26.97217,49514
1111,zz-x404,1,0.00202,13356,26.97419,49514
1112,zzzinho,1,0.00202,13357,26.97621,49514
