rank_number,actor,contributions,percent,cumulative_sum,cumulative_percent,all_contributions
1,NickMeves,3517,11.21850,3517,11.21850,31350
2,braunsonm,257,0.81978,3774,12.03828,31350
3,Izzette,145,0.46252,3919,12.50080,31350
4,miguelborges99,131,0.41786,4050,12.91866,31350
5,isodude,124,0.39553,4174,13.31419,31350
6,morarucostel,123,0.39234,4297,13.70654,31350
7,chkohner,119,0.37959,4416,14.08612,31350
8,babs,111,0.35407,4527,14.44019,31350
9,hevans-dglcom,109,0.34769,4636,14.78788,31350
10,johejo,108,0.34450,4744,15.13238,31350
11,linuxgemini,92,0.29346,4836,15.42584,31350
12,jjlakis,85,0.27113,4921,15.69697,31350
13,papey,83,0.26475,5004,15.96172,31350
14,adriananeci,77,0.24561,5081,16.20734,31350
15,brianv0,70,0.22329,5151,16.43062,31350
16,khawaga,66,0.21053,5217,16.64115,31350
17,erkannt,60,0.19139,5277,16.83254,31350
18,salmanazmat666,57,0.18182,5334,17.01435,31350
19,pcneo83,54,0.17225,5388,17.18660,31350
20,yanasega,53,0.16906,5441,17.35566,31350
21,gargath,50,0.15949,5491,17.51515,31350
22,redboxstudio,50,0.15949,5541,17.67464,31350
23,ScottGuymer,49,0.15630,5590,17.83094,31350
24,r-kotagudem,47,0.14992,5637,17.98086,31350
25,lathspell,45,0.14354,5682,18.12440,31350
26,MNF,44,0.14035,5726,18.26475,31350
27,FStelzer,43,0.13716,5769,18.40191,31350
28,samirachoadi,43,0.13716,5812,18.53907,31350
29,knightian,42,0.13397,5854,18.67305,31350
30,aiciobanu,36,0.11483,5890,18.78788,31350
31,amnay-mo,35,0.11164,5925,18.89952,31350
32,SeWieland,34,0.10845,5959,19.00797,31350
33,willwill96,32,0.10207,5991,19.11005,31350
34,lknite,30,0.09569,6021,19.20574,31350
35,cmbaatz,29,0.09250,6050,19.29825,31350
36,polarctos,29,0.09250,6079,19.39075,31350
37,Beanow,27,0.08612,6106,19.47687,31350
38,gysel,27,0.08612,6133,19.56300,31350
39,michael-freidgeim-webjet,26,0.08293,6159,19.64593,31350
40,rabbers,24,0.07656,6183,19.72249,31350
41,Tristan971,24,0.07656,6207,19.79904,31350
42,salmanisd,23,0.07337,6230,19.87241,31350
43,fnkr,22,0.07018,6252,19.94258,31350
44,Rahul1804,22,0.07018,6274,20.01276,31350
45,bh-tt,21,0.06699,6295,20.07974,31350
46,costelmoraru,21,0.06699,6316,20.14673,31350
47,jordancrawfordnz,21,0.06699,6337,20.21372,31350
48,middagj,21,0.06699,6358,20.28070,31350
49,prince-melvin,21,0.06699,6379,20.34769,31350
50,starkers,21,0.06699,6400,20.41467,31350
51,k0ste,20,0.06380,6420,20.47847,31350
52,linoleparquet,20,0.06380,6440,20.54226,31350
53,priby05,20,0.06380,6460,20.60606,31350
54,yyoshiki41,20,0.06380,6480,20.66986,31350
55,zethis,20,0.06380,6500,20.73365,31350
56,zv0n,20,0.06380,6520,20.79745,31350
57,andoks,19,0.06061,6539,20.85805,31350
58,emsixteeen,19,0.06061,6558,20.91866,31350
59,hskiba,19,0.06061,6577,20.97927,31350
60,mvalenzisi,19,0.06061,6596,21.03987,31350
61,nilsgstrabo,19,0.06061,6615,21.10048,31350
62,rekup,19,0.06061,6634,21.16108,31350
63,rishi1111,19,0.06061,6653,21.22169,31350
64,StefanLobbenmeierObjego,19,0.06061,6672,21.28230,31350
65,stippi2,19,0.06061,6691,21.34290,31350
66,tareco,19,0.06061,6710,21.40351,31350
67,terala,19,0.06061,6729,21.46411,31350
68,timwsuqld,19,0.06061,6748,21.52472,31350
69,UiP9AV6Y,19,0.06061,6767,21.58533,31350
70,htdat148,18,0.05742,6785,21.64274,31350
71,Ornias1993,18,0.05742,6803,21.70016,31350
72,Primexz,18,0.05742,6821,21.75758,31350
73,theGOTOguy,18,0.05742,6839,21.81499,31350
74,bbodensieck,17,0.05423,6856,21.86922,31350
75,m-wcislo,17,0.05423,6873,21.92344,31350
76,nickveenhof,17,0.05423,6890,21.97767,31350
77,rezagh2,17,0.05423,6907,22.03190,31350
78,toshi-miura,17,0.05423,6924,22.08612,31350
79,abhilashjoseph,16,0.05104,6940,22.13716,31350
80,avmp2208,16,0.05104,6956,22.18820,31350
81,copolycube,16,0.05104,6972,22.23923,31350
82,dmahisingh,16,0.05104,6988,22.29027,31350
83,egrif,16,0.05104,7004,22.34131,31350
84,jacobalberty,16,0.05104,7020,22.39234,31350
85,K7cl,16,0.05104,7036,22.44338,31350
86,5h4k4r,15,0.04785,7051,22.49123,31350
87,anonhostpi,15,0.04785,7066,22.53907,31350
88,ASHISHTOM,15,0.04785,7081,22.58692,31350
89,benfdking,15,0.04785,7096,22.63477,31350
90,carillonator,15,0.04785,7111,22.68262,31350
91,edemen,15,0.04785,7126,22.73046,31350
92,ibizaman,15,0.04785,7141,22.77831,31350
93,iTaybb,15,0.04785,7156,22.82616,31350
94,LeVraiRoiDHyrule,15,0.04785,7171,22.87400,31350
95,PSanetra,15,0.04785,7186,22.92185,31350
96,Spindel,15,0.04785,7201,22.96970,31350
97,Teko012,15,0.04785,7216,23.01754,31350
98,tirelibirefe,15,0.04785,7231,23.06539,31350
99,bjencks,14,0.04466,7245,23.11005,31350
100,carabj,14,0.04466,7259,23.15470,31350
101,dasvh,14,0.04466,7273,23.19936,31350
102,e36Alex,14,0.04466,7287,23.24402,31350
103,muffl0n,14,0.04466,7301,23.28868,31350
104,ouven,14,0.04466,7315,23.33333,31350
105,piersharding,14,0.04466,7329,23.37799,31350
106,rustyx,14,0.04466,7343,23.42265,31350
107,tpohl,14,0.04466,7357,23.46730,31350
108,brezinajn,13,0.04147,7370,23.50877,31350
109,dekimsey,13,0.04147,7383,23.55024,31350
110,edorizzardi,13,0.04147,7396,23.59171,31350
111,mikesiegel,13,0.04147,7409,23.63317,31350
112,nbraun-wolf,13,0.04147,7422,23.67464,31350
113,nicoschuck,13,0.04147,7435,23.71611,31350
114,n-i-x,13,0.04147,7448,23.75758,31350
115,oddlama,13,0.04147,7461,23.79904,31350
116,Robinyo,13,0.04147,7474,23.84051,31350
117,segaura,13,0.04147,7487,23.88198,31350
118,tooptoop4,13,0.04147,7500,23.92344,31350
119,aigarius,12,0.03828,7512,23.96172,31350
120,ba1dr,12,0.03828,7524,24.00000,31350
121,Bastian,12,0.03828,7536,24.03828,31350
122,benni336,12,0.03828,7548,24.07656,31350
123,dabde,12,0.03828,7560,24.11483,31350
124,einfachchr,12,0.03828,7572,24.15311,31350
125,idntfy,12,0.03828,7584,24.19139,31350
126,koriit-kontakt,12,0.03828,7596,24.22967,31350
127,marianobilli,12,0.03828,7608,24.26794,31350
128,matzegebbe,12,0.03828,7620,24.30622,31350
129,mosajjal,12,0.03828,7632,24.34450,31350
130,p53,12,0.03828,7644,24.38278,31350
131,TeroPihlaja,12,0.03828,7656,24.42105,31350
132,TuningYourCode,12,0.03828,7668,24.45933,31350
133,urbanpawel90,12,0.03828,7680,24.49761,31350
134,v0tti,12,0.03828,7692,24.53589,31350
135,vegetablest,12,0.03828,7704,24.57416,31350
136,xcabur1,12,0.03828,7716,24.61244,31350
137,yashmehrazs,12,0.03828,7728,24.65072,31350
138,AthinaPl,11,0.03509,7739,24.68581,31350
139,blt,11,0.03509,7750,24.72089,31350
140,BobDu,11,0.03509,7761,24.75598,31350
141,corybolar,11,0.03509,7772,24.79107,31350
142,crbednarz,11,0.03509,7783,24.82616,31350
143,flashpaper12,11,0.03509,7794,24.86124,31350
144,LucaCre,11,0.03509,7805,24.89633,31350
145,mikolajtkaczyk64,11,0.03509,7816,24.93142,31350
146,pasha-r,11,0.03509,7827,24.96651,31350
147,scyto,11,0.03509,7838,25.00159,31350
148,segfault16,11,0.03509,7849,25.03668,31350
149,supracarol,11,0.03509,7860,25.07177,31350
150,ternbusty,11,0.03509,7871,25.10686,31350
151,xelita,11,0.03509,7882,25.14195,31350
152,aajisaka,10,0.03190,7892,25.17384,31350
153,alexdutton,10,0.03190,7902,25.20574,31350
154,andytson,10,0.03190,7912,25.23764,31350
155,beezerk23,10,0.03190,7922,25.26954,31350
156,col-panic,10,0.03190,7932,25.30144,31350
157,devopsix,10,0.03190,7942,25.33333,31350
158,endakelly,10,0.03190,7952,25.36523,31350
159,fcollonval,10,0.03190,7962,25.39713,31350
160,Fez29,10,0.03190,7972,25.42903,31350
161,gempir,10,0.03190,7982,25.46093,31350
162,haydn-j-evans,10,0.03190,7992,25.49282,31350
163,herbrechtsmeier,10,0.03190,8002,25.52472,31350
164,ikarius,10,0.03190,8012,25.55662,31350
165,jgmartinez,10,0.03190,8022,25.58852,31350
166,JohanLindvall,10,0.03190,8032,25.62041,31350
167,kmcentush,10,0.03190,8042,25.65231,31350
168,kr4sv,10,0.03190,8052,25.68421,31350
169,lanmarti,10,0.03190,8062,25.71611,31350
170,LautaroJayat,10,0.03190,8072,25.74801,31350
171,luketainton,10,0.03190,8082,25.77990,31350
172,mariaWitch,10,0.03190,8092,25.81180,31350
173,matpen-wi,10,0.03190,8102,25.84370,31350
174,MisterWil,10,0.03190,8112,25.87560,31350
175,modem7,10,0.03190,8122,25.90750,31350
176,modularTaco,10,0.03190,8132,25.93939,31350
177,oliver006,10,0.03190,8142,25.97129,31350
178,Palollo,10,0.03190,8152,26.00319,31350
179,Ramblurr,10,0.03190,8162,26.03509,31350
180,rbange,10,0.03190,8172,26.06699,31350
181,rshiva777,10,0.03190,8182,26.09888,31350
182,rufreakde,10,0.03190,8192,26.13078,31350
183,sandy2008,10,0.03190,8202,26.16268,31350
184,shkarface,10,0.03190,8212,26.19458,31350
185,TheAnachronism,10,0.03190,8222,26.22648,31350
186,ThomasKalten,10,0.03190,8232,26.25837,31350
187,umershaekoor,10,0.03190,8242,26.29027,31350
188,wardviaene,10,0.03190,8252,26.32217,31350
189,yaroslavros,10,0.03190,8262,26.35407,31350
190,BenjamenMeyer,9,0.02871,8271,26.38278,31350
191,biotom,9,0.02871,8280,26.41148,31350
192,chrta-wmi,9,0.02871,8289,26.44019,31350
193,c-x-berger,9,0.02871,8298,26.46890,31350
194,devildant,9,0.02871,8307,26.49761,31350
195,eloo-abi,9,0.02871,8316,26.52632,31350
196,EtienneBarbier,9,0.02871,8325,26.55502,31350
197,futurelm,9,0.02871,8334,26.58373,31350
198,Hadatko,9,0.02871,8343,26.61244,31350
199,igsol,9,0.02871,8352,26.64115,31350
200,illrill,9,0.02871,8361,26.66986,31350
201,jkjha,9,0.02871,8370,26.69856,31350
202,kobim,9,0.02871,8379,26.72727,31350
203,ksaadDE,9,0.02871,8388,26.75598,31350
204,martin-css,9,0.02871,8397,26.78469,31350
205,matthjes,9,0.02871,8406,26.81340,31350
206,maxh8086,9,0.02871,8415,26.84211,31350
207,MickMake,9,0.02871,8424,26.87081,31350
208,mkjpryor,9,0.02871,8433,26.89952,31350
209,netgusto,9,0.02871,8442,26.92823,31350
210,newhorizs,9,0.02871,8451,26.95694,31350
211,NingPekin,9,0.02871,8460,26.98565,31350
212,numericOverflow,9,0.02871,8469,27.01435,31350
213,OliverLeighC,9,0.02871,8478,27.04306,31350
214,pksheldon4,9,0.02871,8487,27.07177,31350
215,POD666,9,0.02871,8496,27.10048,31350
216,raz3r,9,0.02871,8505,27.12919,31350
217,rd-danny-fleer,9,0.02871,8514,27.15789,31350
218,RO-29,9,0.02871,8523,27.18660,31350
219,SamTV12345,9,0.02871,8532,27.21531,31350
220,smiggiddy,9,0.02871,8541,27.24402,31350
221,soskamp,9,0.02871,8550,27.27273,31350
222,thetrime,9,0.02871,8559,27.30144,31350
223,venushka,9,0.02871,8568,27.33014,31350
224,vishrana,9,0.02871,8577,27.35885,31350
225,vrindanayak,9,0.02871,8586,27.38756,31350
226,xxxbobrxxx,9,0.02871,8595,27.41627,31350
227,98jan,8,0.02552,8603,27.44179,31350
228,ace130-github,8,0.02552,8611,27.46730,31350
229,adevnoob,8,0.02552,8619,27.49282,31350
230,AlexanderYastrebov,8,0.02552,8627,27.51834,31350
231,Alives,8,0.02552,8635,27.54386,31350
232,andreyprezotto,8,0.02552,8643,27.56938,31350
233,anotherthomas,8,0.02552,8651,27.59490,31350
234,bcremer,8,0.02552,8659,27.62041,31350
235,benbro,8,0.02552,8667,27.64593,31350
236,Berjou,8,0.02552,8675,27.67145,31350
237,bradym,8,0.02552,8683,27.69697,31350
238,breedjaram,8,0.02552,8691,27.72249,31350
239,Copilot,8,0.02552,8699,27.74801,31350
240,dadrus,8,0.02552,8707,27.77352,31350
241,dashkan,8,0.02552,8715,27.79904,31350
242,daviirodrig,8,0.02552,8723,27.82456,31350
243,devster31,8,0.02552,8731,27.85008,31350
244,edahlseng,8,0.02552,8739,27.87560,31350
245,EdvardGB,8,0.02552,8747,27.90112,31350
246,Elektordi,8,0.02552,8755,27.92663,31350
247,eloo,8,0.02552,8763,27.95215,31350
248,ericmeadows,8,0.02552,8771,27.97767,31350
249,Farfaday,8,0.02552,8779,28.00319,31350
250,FlomoN,8,0.02552,8787,28.02871,31350
251,franktore,8,0.02552,8795,28.05423,31350
252,ghuser0,8,0.02552,8803,28.07974,31350
253,haoxins,8,0.02552,8811,28.10526,31350
254,Hargeek,8,0.02552,8819,28.13078,31350
255,howzat,8,0.02552,8827,28.15630,31350
256,jpalpant,8,0.02552,8835,28.18182,31350
257,khushbooag4,8,0.02552,8843,28.20734,31350
258,krittidet,8,0.02552,8851,28.23285,31350
259,matt-cote,8,0.02552,8859,28.25837,31350
260,michaelbayles,8,0.02552,8867,28.28389,31350
261,pbxqdown,8,0.02552,8875,28.30941,31350
262,peppered,8,0.02552,8883,28.33493,31350
263,pgroudas,8,0.02552,8891,28.36045,31350
264,pratiyushpushkar05,8,0.02552,8899,28.38596,31350
265,RonanMorgan,8,0.02552,8907,28.41148,31350
266,saez0pub,8,0.02552,8915,28.43700,31350
267,Schueni1,8,0.02552,8923,28.46252,31350
268,stes,8,0.02552,8931,28.48804,31350
269,thebigbone,8,0.02552,8939,28.51356,31350
270,VF-mbrauer,8,0.02552,8947,28.53907,31350
271,wollomatic,8,0.02552,8955,28.56459,31350
272,xyzroller,8,0.02552,8963,28.59011,31350
273,5w0ng,7,0.02233,8970,28.61244,31350
274,ahovgaard,7,0.02233,8977,28.63477,31350
275,aledeganopix4d,7,0.02233,8984,28.65710,31350
276,alexbde,7,0.02233,8991,28.67943,31350
277,anst270125,7,0.02233,8998,28.70175,31350
278,CesarStef,7,0.02233,9005,28.72408,31350
279,cfra,7,0.02233,9012,28.74641,31350
280,charvadzo,7,0.02233,9019,28.76874,31350
281,cschyma,7,0.02233,9026,28.79107,31350
282,davidy718,7,0.02233,9033,28.81340,31350
283,erik-h,7,0.02233,9040,28.83573,31350
284,etho201,7,0.02233,9047,28.85805,31350
285,gitdr,7,0.02233,9054,28.88038,31350
286,gowrisankar22,7,0.02233,9061,28.90271,31350
287,grjones,7,0.02233,9068,28.92504,31350
288,harzallah,7,0.02233,9075,28.94737,31350
289,henriduflot,7,0.02233,9082,28.96970,31350
290,hirendave47,7,0.02233,9089,28.99203,31350
291,iamfarsk,7,0.02233,9096,29.01435,31350
292,J3m5,7,0.02233,9103,29.03668,31350
293,jonerer,7,0.02233,9110,29.05901,31350
294,josh-thisisbud,7,0.02233,9117,29.08134,31350
295,jrnewton,7,0.02233,9124,29.10367,31350
296,ledoyen,7,0.02233,9131,29.12600,31350
297,lgthibault,7,0.02233,9138,29.14833,31350
298,lmsurpre,7,0.02233,9145,29.17065,31350
299,max-te,7,0.02233,9152,29.19298,31350
300,mbld,7,0.02233,9159,29.21531,31350
301,mikefab-msf,7,0.02233,9166,29.23764,31350
302,mkocaks,7,0.02233,9173,29.25997,31350
303,mohsek,7,0.02233,9180,29.28230,31350
304,n1tehawk,7,0.02233,9187,29.30463,31350
305,NiroDeveloper,7,0.02233,9194,29.32695,31350
306,nivimorbgp,7,0.02233,9201,29.34928,31350
307,opteemister,7,0.02233,9208,29.37161,31350
308,Overv,7,0.02233,9215,29.39394,31350
309,phllpmcphrsn,7,0.02233,9222,29.41627,31350
310,prevostc,7,0.02233,9229,29.43860,31350
311,samiracho,7,0.02233,9236,29.46093,31350
312,Sandy1438,7,0.02233,9243,29.48325,31350
313,sarojkandel12,7,0.02233,9250,29.50558,31350
314,sedghi,7,0.02233,9257,29.52791,31350
315,ShyLionTjmn,7,0.02233,9264,29.55024,31350
316,sja,7,0.02233,9271,29.57257,31350
317,sosiskin2000,7,0.02233,9278,29.59490,31350
318,toote,7,0.02233,9285,29.61722,31350
319,tsraza,7,0.02233,9292,29.63955,31350
320,wassan128,7,0.02233,9299,29.66188,31350
321,younsl,7,0.02233,9306,29.68421,31350
322,yudrywet,7,0.02233,9313,29.70654,31350
323,YusukeIwaki,7,0.02233,9320,29.72887,31350
324,zoriax,7,0.02233,9327,29.75120,31350
325,aaktaev,6,0.01914,9333,29.77033,31350
326,admincasper,6,0.01914,9339,29.78947,31350
327,alank976,6,0.01914,9345,29.80861,31350
328,AlexanderWells-diamond,6,0.01914,9351,29.82775,31350
329,appcoders,6,0.01914,9357,29.84689,31350
330,avila-m-6,6,0.01914,9363,29.86603,31350
331,benjaminmposnick,6,0.01914,9369,29.88517,31350
332,breedjaram32,6,0.01914,9375,29.90431,31350
333,CAR6807,6,0.01914,9381,29.92344,31350
334,carrot-hub,6,0.01914,9387,29.94258,31350
335,cazpr,6,0.01914,9393,29.96172,31350
336,C-Duv,6,0.01914,9399,29.98086,31350
337,ciffelia,6,0.01914,9405,30.00000,31350
338,cnhsn,6,0.01914,9411,30.01914,31350
339,daddonpa,6,0.01914,9417,30.03828,31350
340,daniel-mersch,6,0.01914,9423,30.05742,31350
341,DaveOHenry,6,0.01914,9429,30.07656,31350
342,dchen71,6,0.01914,9435,30.09569,31350
343,devopstagon,6,0.01914,9441,30.11483,31350
344,djarbz,6,0.01914,9447,30.13397,31350
345,dulakm,6,0.01914,9453,30.15311,31350
346,FAUSheppy,6,0.01914,9459,30.17225,31350
347,felipeconti,6,0.01914,9465,30.19139,31350
348,gangadharjannu,6,0.01914,9471,30.21053,31350
349,gianluca1606,6,0.01914,9477,30.22967,31350
350,gurumark,6,0.01914,9483,30.24880,31350
351,haileys,6,0.01914,9489,30.26794,31350
352,haslersn,6,0.01914,9495,30.28708,31350
353,implr,6,0.01914,9501,30.30622,31350
354,istvano,6,0.01914,9507,30.32536,31350
355,jansinger,6,0.01914,9513,30.34450,31350
356,jeff1985,6,0.01914,9519,30.36364,31350
357,jeroenlandheer,6,0.01914,9525,30.38278,31350
358,jheidbrink,6,0.01914,9531,30.40191,31350
359,jin-ahn,6,0.01914,9537,30.42105,31350
360,Jleagle,6,0.01914,9543,30.44019,31350
361,joseerlang,6,0.01914,9549,30.45933,31350
362,JVecsei,6,0.01914,9555,30.47847,31350
363,kbabuadze,6,0.01914,9561,30.49761,31350
364,krlmlr,6,0.01914,9567,30.51675,31350
365,LeeMartin77,6,0.01914,9573,30.53589,31350
366,Mahesh-Gunda-Maersk,6,0.01914,9579,30.55502,31350
367,matpen,6,0.01914,9585,30.57416,31350
368,matthewoden,6,0.01914,9591,30.59330,31350
369,mentlak0,6,0.01914,9597,30.61244,31350
370,ming-zhang-SN,6,0.01914,9603,30.63158,31350
371,miniksa,6,0.01914,9609,30.65072,31350
372,mleneveut,6,0.01914,9615,30.66986,31350
373,myspaghetti,6,0.01914,9621,30.68900,31350
374,natefear,6,0.01914,9627,30.70813,31350
375,nissimbitan,6,0.01914,9633,30.72727,31350
376,ofir-amir,6,0.01914,9639,30.74641,31350
377,omeryesil,6,0.01914,9645,30.76555,31350
378,pancudaniel7,6,0.01914,9651,30.78469,31350
379,Peperud,6,0.01914,9657,30.80383,31350
380,remkolodder,6,0.01914,9663,30.82297,31350
381,rikroe,6,0.01914,9669,30.84211,31350
382,rlacko58,6,0.01914,9675,30.86124,31350
383,scarolac,6,0.01914,9681,30.88038,31350
384,sebwills,6,0.01914,9687,30.89952,31350
385,seumassoltysik,6,0.01914,9693,30.91866,31350
386,shivknight,6,0.01914,9699,30.93780,31350
387,silverwzw,6,0.01914,9705,30.95694,31350
388,sribee,6,0.01914,9711,30.97608,31350
389,stomekpe,6,0.01914,9717,30.99522,31350
390,sushiMix,6,0.01914,9723,31.01435,31350
391,tfmm,6,0.01914,9729,31.03349,31350
392,thebestgin,6,0.01914,9735,31.05263,31350
393,tlex,6,0.01914,9741,31.07177,31350
394,truong-hua,6,0.01914,9747,31.09091,31350
395,uvaisibrahim,6,0.01914,9753,31.11005,31350
396,wahlflo,6,0.01914,9759,31.12919,31350
397,webnard,6,0.01914,9765,31.14833,31350
398,william-bohannan,6,0.01914,9771,31.16746,31350
399,winweb123,6,0.01914,9777,31.18660,31350
400,yburke94,6,0.01914,9783,31.20574,31350
401,Zocker1999NET,6,0.01914,9789,31.22488,31350
402,adam-long,5,0.01595,9794,31.24083,31350
403,albert0815,5,0.01595,9799,31.25678,31350
404,alexmwinter,5,0.01595,9804,31.27273,31350
405,ap1969,5,0.01595,9809,31.28868,31350
406,ashishkf,5,0.01595,9814,31.30463,31350
407,bancek,5,0.01595,9819,31.32057,31350
408,bhavik-patel24,5,0.01595,9824,31.33652,31350
409,blevine,5,0.01595,9829,31.35247,31350
410,bodom0015,5,0.01595,9834,31.36842,31350
411,bputt-e,5,0.01595,9839,31.38437,31350
412,bradybus,5,0.01595,9844,31.40032,31350
413,cccs-cat001,5,0.01595,9849,31.41627,31350
414,chadmiller-saq,5,0.01595,9854,31.43222,31350
415,chandu412,5,0.01595,9859,31.44817,31350
416,ckwalsh,5,0.01595,9864,31.46411,31350
417,DevSecNinja,5,0.01595,9869,31.48006,31350
418,diabda2,5,0.01595,9874,31.49601,31350
419,diyaachar,5,0.01595,9879,31.51196,31350
420,dkekel,5,0.01595,9884,31.52791,31350
421,dmasbb,5,0.01595,9889,31.54386,31350
422,dsantanu,5,0.01595,9894,31.55981,31350
423,eerichmond,5,0.01595,9899,31.57576,31350
424,egibs,5,0.01595,9904,31.59171,31350
425,eltharynd,5,0.01595,9909,31.60766,31350
426,filipecifali,5,0.01595,9914,31.62360,31350
427,foosinn,5,0.01595,9919,31.63955,31350
428,forestm,5,0.01595,9924,31.65550,31350
429,gabrielperezs,5,0.01595,9929,31.67145,31350
430,halvardssm,5,0.01595,9934,31.68740,31350
431,haowang-pony,5,0.01595,9939,31.70335,31350
432,hoax,5,0.01595,9944,31.71930,31350
433,holmesb,5,0.01595,9949,31.73525,31350
434,ianldgs,5,0.01595,9954,31.75120,31350
435,IDlOT,5,0.01595,9959,31.76715,31350
436,iliuta,5,0.01595,9964,31.78309,31350
437,japrogramer,5,0.01595,9969,31.79904,31350
438,jemag,5,0.01595,9974,31.81499,31350
439,jmigual,5,0.01595,9979,31.83094,31350
440,jplana,5,0.01595,9984,31.84689,31350
441,K7-Lenovo,5,0.01595,9989,31.86284,31350
442,leyshon,5,0.01595,9994,31.87879,31350
443,ljcodigo,5,0.01595,9999,31.89474,31350
444,loicoudot,5,0.01595,10004,31.91069,31350
445,marjus45,5,0.01595,10009,31.92663,31350
446,mark-nexplore,5,0.01595,10014,31.94258,31350
447,martin-loetzsch,5,0.01595,10019,31.95853,31350
448,mateuszkula1,5,0.01595,10024,31.97448,31350
449,mhienle,5,0.01595,10029,31.99043,31350
450,mikeeh24,5,0.01595,10034,32.00638,31350
451,mnsaybi,5,0.01595,10039,32.02233,31350
452,Montralis,5,0.01595,10044,32.03828,31350
453,Naveenrajelothunkal,5,0.01595,10049,32.05423,31350
454,NikitaIvankov1992,5,0.01595,10054,32.07018,31350
455,niraizik,5,0.01595,10059,32.08612,31350
456,nobletrout,5,0.01595,10064,32.10207,31350
457,olitez,5,0.01595,10069,32.11802,31350
458,Oliver-Hanikel,5,0.01595,10074,32.13397,31350
459,Orange-Rabbit,5,0.01595,10079,32.14992,31350
460,PavelDemyanenko,5,0.01595,10084,32.16587,31350
461,ph4nt0m,5,0.01595,10089,32.18182,31350
462,r4co0n,5,0.01595,10094,32.19777,31350
463,rastogin-rp,5,0.01595,10099,32.21372,31350
464,realindiahotel,5,0.01595,10104,32.22967,31350
465,RicardoFernandez-UY,5,0.01595,10109,32.24561,31350
466,roey383,5,0.01595,10114,32.26156,31350
467,rparree,5,0.01595,10119,32.27751,31350
468,rye-freedom,5,0.01595,10124,32.29346,31350
469,sanchesfrolov,5,0.01595,10129,32.30941,31350
470,shawnhwei,5,0.01595,10134,32.32536,31350
471,slashbeast,5,0.01595,10139,32.34131,31350
472,SleepyBag,5,0.01595,10144,32.35726,31350
473,stigok,5,0.01595,10149,32.37321,31350
474,strboul,5,0.01595,10154,32.38915,31350
475,Sumon01829,5,0.01595,10159,32.40510,31350
476,superlazyname,5,0.01595,10164,32.42105,31350
477,teceP,5,0.01595,10169,32.43700,31350
478,thiagocaiubi,5,0.01595,10174,32.45295,31350
479,thomashargrove,5,0.01595,10179,32.46890,31350
480,tristanbuckner,5,0.01595,10184,32.48485,31350
481,twendt,5,0.01595,10189,32.50080,31350
482,wccropper,5,0.01595,10194,32.51675,31350
483,weltonrodrigo,5,0.01595,10199,32.53270,31350
484,wesbrownfavor,5,0.01595,10204,32.54864,31350
485,william-will-angi,5,0.01595,10209,32.56459,31350
486,Yc-Chen,5,0.01595,10214,32.58054,31350
487,YenTheFirst,5,0.01595,10219,32.59649,31350
488,YoavOst,5,0.01595,10224,32.61244,31350
489,zanghao2,5,0.01595,10229,32.62839,31350
490,zucaritask,5,0.01595,10234,32.64434,31350
491,adelsz,4,0.01276,10238,32.65710,31350
492,Adminiuga,4,0.01276,10242,32.66986,31350
493,aimichal,4,0.01276,10246,32.68262,31350
494,air3ijai,4,0.01276,10250,32.69537,31350
495,aizzi,4,0.01276,10254,32.70813,31350
496,alex-shakudo,4,0.01276,10258,32.72089,31350
497,allanian,4,0.01276,10262,32.73365,31350
498,amigthea,4,0.01276,10266,32.74641,31350
499,amithkk,4,0.01276,10270,32.75917,31350
500,andrewdbate,4,0.01276,10274,32.77193,31350
501,andytson-inviqa,4,0.01276,10278,32.78469,31350
502,aplovich,4,0.01276,10282,32.79745,31350
503,asagecty,4,0.01276,10286,32.81021,31350
504,athoune,4,0.01276,10290,32.82297,31350
505,atringle,4,0.01276,10294,32.83573,31350
506,attilaolah,4,0.01276,10298,32.84848,31350
507,attiss,4,0.01276,10302,32.86124,31350
508,AurelienBegou,4,0.01276,10306,32.87400,31350
509,avakarev,4,0.01276,10310,32.88676,31350
510,avoltz,4,0.01276,10314,32.89952,31350
511,ayushmpb95,4,0.01276,10318,32.91228,31350
512,azat431km,4,0.01276,10322,32.92504,31350
513,BenasB,4,0.01276,10326,32.93780,31350
514,betabandido,4,0.01276,10330,32.95056,31350
515,bhayden53,4,0.01276,10334,32.96332,31350
516,BitForger,4,0.01276,10338,32.97608,31350
517,bit-herder,4,0.01276,10342,32.98884,31350
518,bmgante,4,0.01276,10346,33.00159,31350
519,btrepp,4,0.01276,10350,33.01435,31350
520,cahya-wirawan,4,0.01276,10354,33.02711,31350
521,calster6,4,0.01276,10358,33.03987,31350
522,ccauet,4,0.01276,10362,33.05263,31350
523,c-dev-acc1,4,0.01276,10366,33.06539,31350
524,Centzilius,4,0.01276,10370,33.07815,31350
525,cheungpatrick,4,0.01276,10374,33.09091,31350
526,ChrisDoernen,4,0.01276,10378,33.10367,31350
527,chunjiw,4,0.01276,10382,33.11643,31350
528,crablab,4,0.01276,10386,33.12919,31350
529,croneter,4,0.01276,10390,33.14195,31350
530,curamos,4,0.01276,10394,33.15470,31350
531,daroga0002,4,0.01276,10398,33.16746,31350
532,deggja,4,0.01276,10402,33.18022,31350
533,deshah04,4,0.01276,10406,33.19298,31350
534,devopstales,4,0.01276,10410,33.20574,31350
535,DimitrijeManic,4,0.01276,10414,33.21850,31350
536,dimitrios-git,4,0.01276,10418,33.23126,31350
537,domdomegg,4,0.01276,10422,33.24402,31350
538,drehelis,4,0.01276,10426,33.25678,31350
539,dsb3,4,0.01276,10430,33.26954,31350
540,easayliu,4,0.01276,10434,33.28230,31350
541,EinavDanielDX,4,0.01276,10438,33.29506,31350
542,elliotdobson,4,0.01276,10442,33.30781,31350
543,erikschul,4,0.01276,10446,33.32057,31350
544,erwen,4,0.01276,10450,33.33333,31350
545,esteiner,4,0.01276,10454,33.34609,31350
546,fopina,4,0.01276,10458,33.35885,31350
547,Fran-Rg,4,0.01276,10462,33.37161,31350
548,gabrielrotaru,4,0.01276,10466,33.38437,31350
549,gannaramu,4,0.01276,10470,33.39713,31350
550,geekhckr,4,0.01276,10474,33.40989,31350
551,geemorin,4,0.01276,10478,33.42265,31350
552,gerhard-strauss-jambit,4,0.01276,10482,33.43541,31350
553,ginkel,4,0.01276,10486,33.44817,31350
554,gitgabz,4,0.01276,10490,33.46093,31350
555,giuliohome,4,0.01276,10494,33.47368,31350
556,gmenuel,4,0.01276,10498,33.48644,31350
557,Goodsmileduck,4,0.01276,10502,33.49920,31350
558,GregoireW,4,0.01276,10506,33.51196,31350
559,Hadsch,4,0.01276,10510,33.52472,31350
560,hahmad92,4,0.01276,10514,33.53748,31350
561,hakimsabery,4,0.01276,10518,33.55024,31350
562,harshitmahapatra,4,0.01276,10522,33.56300,31350
563,hoffrocket,4,0.01276,10526,33.57576,31350
564,IgorMilavec,4,0.01276,10530,33.58852,31350
565,iilr-g,4,0.01276,10534,33.60128,31350
566,illes,4,0.01276,10538,33.61404,31350
567,imnotjc,4,0.01276,10542,33.62679,31350
568,insanemal,4,0.01276,10546,33.63955,31350
569,irh-hdh,4,0.01276,10550,33.65231,31350
570,irizzant,4,0.01276,10554,33.66507,31350
571,ismaelpadilla,4,0.01276,10558,33.67783,31350
572,ITBeyder,4,0.01276,10562,33.69059,31350
573,jan-brychta,4,0.01276,10566,33.70335,31350
574,jankatins,4,0.01276,10570,33.71611,31350
575,jawys,4,0.01276,10574,33.72887,31350
576,JcGKitten,4,0.01276,10578,33.74163,31350
577,jdequatrebarbeszenvalue,4,0.01276,10582,33.75439,31350
578,jet-go,4,0.01276,10586,33.76715,31350
579,jsclayton,4,0.01276,10590,33.77990,31350
580,jstsddg,4,0.01276,10594,33.79266,31350
581,julien-sugg,4,0.01276,10598,33.80542,31350
582,JustinGuese,4,0.01276,10602,33.81818,31350
583,Kamilczak020,4,0.01276,10606,33.83094,31350
584,karl18,4,0.01276,10610,33.84370,31350
585,kaushall,4,0.01276,10614,33.85646,31350
586,kjoth,4,0.01276,10618,33.86922,31350
587,Kranzes,4,0.01276,10622,33.88198,31350
588,krin-wang,4,0.01276,10626,33.89474,31350
589,KSchmeeds,4,0.01276,10630,33.90750,31350
590,KshitijaR16,4,0.01276,10634,33.92026,31350
591,kvc-1,4,0.01276,10638,33.93301,31350
592,latiif,4,0.01276,10642,33.94577,31350
593,leshik,4,0.01276,10646,33.95853,31350
594,lgiommi,4,0.01276,10650,33.97129,31350
595,louisgls,4,0.01276,10654,33.98405,31350
596,luka-mikec,4,0.01276,10658,33.99681,31350
597,Macrame,4,0.01276,10662,34.00957,31350
598,maglub,4,0.01276,10666,34.02233,31350
599,malys,4,0.01276,10670,34.03509,31350
600,manning-ncsa,4,0.01276,10674,34.04785,31350
601,mannp,4,0.01276,10678,34.06061,31350
602,marcojarjour,4,0.01276,10682,34.07337,31350
603,martinelli-francesco,4,0.01276,10686,34.08612,31350
604,martinkovacik,4,0.01276,10690,34.09888,31350
605,MatteoGioioso,4,0.01276,10694,34.11164,31350
606,Mattes83,4,0.01276,10698,34.12440,31350
607,mattharrigan,4,0.01276,10702,34.13716,31350
608,maxl2287,4,0.01276,10706,34.14992,31350
609,max-pfeiffer,4,0.01276,10710,34.16268,31350
610,mccallumjeff,4,0.01276,10714,34.17544,31350
611,melanger,4,0.01276,10718,34.18820,31350
612,mezzinea,4,0.01276,10722,34.20096,31350
613,michaelkoetter,4,0.01276,10726,34.21372,31350
614,minijerome,4,0.01276,10730,34.22648,31350
615,mmajewski-be,4,0.01276,10734,34.23923,31350
616,MoatazAbdallh,4,0.01276,10738,34.25199,31350
617,mooreds,4,0.01276,10742,34.26475,31350
618,MrDeerly,4,0.01276,10746,34.27751,31350
619,myukselen,4,0.01276,10750,34.29027,31350
620,nakshathru,4,0.01276,10754,34.30303,31350
621,newtoworld999,4,0.01276,10758,34.31579,31350
622,Ofinka,4,0.01276,10762,34.32855,31350
623,olivierlambert,4,0.01276,10766,34.34131,31350
624,OOTS,4,0.01276,10770,34.35407,31350
625,pablopla,4,0.01276,10774,34.36683,31350
626,pbitante,4,0.01276,10778,34.37959,31350
627,pfragoso,4,0.01276,10782,34.39234,31350
628,philthynz,4,0.01276,10786,34.40510,31350
629,pievalentin,4,0.01276,10790,34.41786,31350
630,piotrgwiazda,4,0.01276,10794,34.43062,31350
631,PrettySolution,4,0.01276,10798,34.44338,31350
632,priggad,4,0.01276,10802,34.45614,31350
633,psreddy22,4,0.01276,10806,34.46890,31350
634,pxnis,4,0.01276,10810,34.48166,31350
635,quintesse,4,0.01276,10814,34.49442,31350
636,radical-edo,4,0.01276,10818,34.50718,31350
637,Renz2018,4,0.01276,10822,34.51994,31350
638,rfahsel3,4,0.01276,10826,34.53270,31350
639,RichardSieg,4,0.01276,10830,34.54545,31350
640,rickardp,4,0.01276,10834,34.55821,31350
641,roeizavida,4,0.01276,10838,34.57097,31350
642,romanbilenko174,4,0.01276,10842,34.58373,31350
643,romanstech,4,0.01276,10846,34.59649,31350
644,romil-punetha,4,0.01276,10850,34.60925,31350
645,rpateljci,4,0.01276,10854,34.62201,31350
646,ryandesign,4,0.01276,10858,34.63477,31350
647,s14r,4,0.01276,10862,34.64753,31350
648,sahil-sharma,4,0.01276,10866,34.66029,31350
649,sajithvasu,4,0.01276,10870,34.67305,31350
650,sfc-gh-mdwarasila,4,0.01276,10874,34.68581,31350
651,shaheislam,4,0.01276,10878,34.69856,31350
652,shairozan,4,0.01276,10882,34.71132,31350
653,shywei,4,0.01276,10886,34.72408,31350
654,silcowitz,4,0.01276,10890,34.73684,31350
655,simaotwx,4,0.01276,10894,34.74960,31350
656,sivarama-p-raju,4,0.01276,10898,34.76236,31350
657,skuethe,4,0.01276,10902,34.77512,31350
658,SSAR13,4,0.01276,10906,34.78788,31350
659,SSchwaiger,4,0.01276,10910,34.80064,31350
660,Steffi14,4,0.01276,10914,34.81340,31350
661,stephank,4,0.01276,10918,34.82616,31350
662,suhrm1,4,0.01276,10922,34.83892,31350
663,talam,4,0.01276,10926,34.85167,31350
664,t-animal,4,0.01276,10930,34.86443,31350
665,thatInfrastructureGuy,4,0.01276,10934,34.87719,31350
666,tolson-vkn,4,0.01276,10938,34.88995,31350
667,tupos,4,0.01276,10942,34.90271,31350
668,unfor19,4,0.01276,10946,34.91547,31350
669,Vedant-Mhatre-19,4,0.01276,10950,34.92823,31350
670,watsuwo,4,0.01276,10954,34.94099,31350
671,WhiteRabbit-Code,4,0.01276,10958,34.95375,31350
672,Whoveros,4,0.01276,10962,34.96651,31350
673,Wikiwix,4,0.01276,10966,34.97927,31350
674,yaegor,4,0.01276,10970,34.99203,31350
675,ZHANNARaykh,4,0.01276,10974,35.00478,31350
676,zs-dima,4,0.01276,10978,35.01754,31350
677,aashishkoirala,3,0.00957,10981,35.02711,31350
678,aberhallo,3,0.00957,10984,35.03668,31350
679,adamchengtkc,3,0.00957,10987,35.04625,31350
680,AdamJacobMuller,3,0.00957,10990,35.05582,31350
681,adamsong,3,0.00957,10993,35.06539,31350
682,adarshsingh2,3,0.00957,10996,35.07496,31350
683,Adoliin,3,0.00957,10999,35.08453,31350
684,ahoeing,3,0.00957,11002,35.09410,31350
685,aidevops1,3,0.00957,11005,35.10367,31350
686,akunzai,3,0.00957,11008,35.11324,31350
687,Alanoll,3,0.00957,11011,35.12281,31350
688,alasdairnicol,3,0.00957,11014,35.13238,31350
689,albrechtflo-hg,3,0.00957,11017,35.14195,31350
690,aledt,3,0.00957,11020,35.15152,31350
691,aleks-programmer,3,0.00957,11023,35.16108,31350
692,AlexanderBabel,3,0.00957,11026,35.17065,31350
693,alexisdondon,3,0.00957,11029,35.18022,31350
694,Alex-Sizov,3,0.00957,11032,35.18979,31350
695,alexyao2015,3,0.00957,11035,35.19936,31350
696,ampc,3,0.00957,11038,35.20893,31350
697,anamnoid,3,0.00957,11041,35.21850,31350
698,anand188,3,0.00957,11044,35.22807,31350
699,andreb89,3,0.00957,11047,35.23764,31350
700,anita-steiner,3,0.00957,11050,35.24721,31350
701,anon-17c93f9058c5713521dafa1f705415b30e170535,3,0.00957,11053,35.25678,31350
702,AntonAleksandrov13,3,0.00957,11056,35.26635,31350
703,antoniocasagrande-airia,3,0.00957,11059,35.27592,31350
704,anvoltz-msft,3,0.00957,11062,35.28549,31350
705,arhamGH,3,0.00957,11065,35.29506,31350
706,artur-ptaszek-mck,3,0.00957,11068,35.30463,31350
707,atrabulsi,3,0.00957,11071,35.31419,31350
708,avanier,3,0.00957,11074,35.32376,31350
709,azgaviperr,3,0.00957,11077,35.33333,31350
710,bala151187,3,0.00957,11080,35.34290,31350
711,Bananenbieger1234,3,0.00957,11083,35.35247,31350
712,bartlomiejduda,3,0.00957,11086,35.36204,31350
713,beatrausch,3,0.00957,11089,35.37161,31350
714,betullapina,3,0.00957,11092,35.38118,31350
715,BeyondEvil,3,0.00957,11095,35.39075,31350
716,Bhautik0110,3,0.00957,11098,35.40032,31350
717,Biboba,3,0.00957,11101,35.40989,31350
718,blang,3,0.00957,11104,35.41946,31350
719,bozzo,3,0.00957,11107,35.42903,31350
720,brian-mcnamara,3,0.00957,11110,35.43860,31350
721,bungoume,3,0.00957,11113,35.44817,31350
722,caizixian,3,0.00957,11116,35.45774,31350
723,Capitrium,3,0.00957,11119,35.46730,31350
724,cat-paylead,3,0.00957,11122,35.47687,31350
725,cguy,3,0.00957,11125,35.48644,31350
726,ch08532,3,0.00957,11128,35.49601,31350
727,ch3njust1n,3,0.00957,11131,35.50558,31350
728,chadmyers,3,0.00957,11134,35.51515,31350
729,cheesemarathon,3,0.00957,11137,35.52472,31350
730,ChillAndImprove,3,0.00957,11140,35.53429,31350
731,chlasch,3,0.00957,11143,35.54386,31350
732,chr1st1ank,3,0.00957,11146,35.55343,31350
733,colinjfw,3,0.00957,11149,35.56300,31350
734,compgumby,3,0.00957,11152,35.57257,31350
735,conet,3,0.00957,11155,35.58214,31350
736,cstisa,3,0.00957,11158,35.59171,31350
737,CyberSeppi,3,0.00957,11161,35.60128,31350
738,czenker,3,0.00957,11164,35.61085,31350
739,d02540315,3,0.00957,11167,35.62041,31350
740,DaBonse,3,0.00957,11170,35.62998,31350
741,dagdynamik,3,0.00957,11173,35.63955,31350
742,danielc103,3,0.00957,11176,35.64912,31350
743,DanielHabenicht,3,0.00957,11179,35.65869,31350
744,danielhstahl,3,0.00957,11182,35.66826,31350
745,DaniloRochaGR7,3,0.00957,11185,35.67783,31350
746,danksim,3,0.00957,11188,35.68740,31350
747,davidroth,3,0.00957,11191,35.69697,31350
748,DeividsP-P,3,0.00957,11194,35.70654,31350
749,demurray,3,0.00957,11197,35.71611,31350
750,detvdl,3,0.00957,11200,35.72568,31350
751,dhedberg,3,0.00957,11203,35.73525,31350
752,dicky1218,3,0.00957,11206,35.74482,31350
753,diegopazosrego,3,0.00957,11209,35.75439,31350
754,dklein-net,3,0.00957,11212,35.76396,31350
755,dmnemec,3,0.00957,11215,35.77352,31350
756,doniz,3,0.00957,11218,35.78309,31350
757,dup2,3,0.00957,11221,35.79266,31350
758,dwestheide,3,0.00957,11224,35.80223,31350
759,ebcFlagman,3,0.00957,11227,35.81180,31350
760,ebuzzz,3,0.00957,11230,35.82137,31350
761,EHSchmitt4395,3,0.00957,11233,35.83094,31350
762,EinarArnason,3,0.00957,11236,35.84051,31350
763,elnappo,3,0.00957,11239,35.85008,31350
764,ericproulx,3,0.00957,11242,35.85965,31350
765,eritikass,3,0.00957,11245,35.86922,31350
766,estroem,3,0.00957,11248,35.87879,31350
767,etiennejournet,3,0.00957,11251,35.88836,31350
768,evilfer,3,0.00957,11254,35.89793,31350
769,eyonasi,3,0.00957,11257,35.90750,31350
770,feg624,3,0.00957,11260,35.91707,31350
771,ffais,3,0.00957,11263,35.92663,31350
772,Fox32,3,0.00957,11266,35.93620,31350
773,fratschi,3,0.00957,11269,35.94577,31350
774,frco9,3,0.00957,11272,35.95534,31350
775,freedrikp,3,0.00957,11275,35.96491,31350
776,futik,3,0.00957,11278,35.97448,31350
777,geudrik,3,0.00957,11281,35.98405,31350
778,gfrankliu,3,0.00957,11284,35.99362,31350
779,ghdiska,3,0.00957,11287,36.00319,31350
780,glikpsc,3,0.00957,11290,36.01276,31350
781,grufocom,3,0.00957,11293,36.02233,31350
782,guilhem-sante,3,0.00957,11296,36.03190,31350
783,gustabart,3,0.00957,11299,36.04147,31350
784,haavardw,3,0.00957,11302,36.05104,31350
785,Hellzed,3,0.00957,11305,36.06061,31350
786,hnaidin,3,0.00957,11308,36.07018,31350
787,holotrack,3,0.00957,11311,36.07974,31350
788,Honsei901,3,0.00957,11314,36.08931,31350
789,horihel,3,0.00957,11317,36.09888,31350
790,Hyuga-Tsukui,3,0.00957,11320,36.10845,31350
791,ianssoftcom,3,0.00957,11323,36.11802,31350
792,ingtarius,3,0.00957,11326,36.12759,31350
793,ion-elgreco,3,0.00957,11329,36.13716,31350
794,i-segura,3,0.00957,11332,36.14673,31350
795,ishchatul,3,0.00957,11335,36.15630,31350
796,jachym-tousek-keboola,3,0.00957,11338,36.16587,31350
797,jacobsin,3,0.00957,11341,36.17544,31350
798,janevits,3,0.00957,11344,36.18501,31350
799,jasondarwin,3,0.00957,11347,36.19458,31350
800,jauco,3,0.00957,11350,36.20415,31350
801,jemega,3,0.00957,11353,36.21372,31350
802,jess-belliveau,3,0.00957,11356,36.22329,31350
803,jijilonline,3,0.00957,11359,36.23285,31350
804,joaopalma5,3,0.00957,11362,36.24242,31350
805,johnswarbrick,3,0.00957,11365,36.25199,31350
806,johnswarbrick-napier,3,0.00957,11368,36.26156,31350
807,joker32,3,0.00957,11371,36.27113,31350
808,jonathandavis805,3,0.00957,11374,36.28070,31350
809,jonwolski,3,0.00957,11377,36.29027,31350
810,josephElhajj,3,0.00957,11380,36.29984,31350
811,Jozefiel,3,0.00957,11383,36.30941,31350
812,jwie-idirect,3,0.00957,11386,36.31898,31350
813,jz222,3,0.00957,11389,36.32855,31350
814,kaarlov,3,0.00957,11392,36.33812,31350
815,kaktus42,3,0.00957,11395,36.34769,31350
816,kalinkostashki,3,0.00957,11398,36.35726,31350
817,KamranBiglari,3,0.00957,11401,36.36683,31350
818,kevin93w,3,0.00957,11404,36.37640,31350
819,khift363,3,0.00957,11407,36.38596,31350
820,kian,3,0.00957,11410,36.39553,31350
821,komalarg2010,3,0.00957,11413,36.40510,31350
822,krodyrobi,3,0.00957,11416,36.41467,31350
823,l1n,3,0.00957,11419,36.42424,31350
824,lagunary,3,0.00957,11422,36.43381,31350
825,languitar,3,0.00957,11425,36.44338,31350
826,latituder,3,0.00957,11428,36.45295,31350
827,LordEvron,3,0.00957,11431,36.46252,31350
828,lruppe,3,0.00957,11434,36.47209,31350
829,lubaskinc0de,3,0.00957,11437,36.48166,31350
830,lubo,3,0.00957,11440,36.49123,31350
831,lukas-holzner,3,0.00957,11443,36.50080,31350
832,lulzmachine,3,0.00957,11446,36.51037,31350
833,lumoVWGS,3,0.00957,11449,36.51994,31350
834,Luth1ng,3,0.00957,11452,36.52951,31350
835,mafi81,3,0.00957,11455,36.53907,31350
836,MageshAnand,3,0.00957,11458,36.54864,31350
837,MagicRB,3,0.00957,11461,36.55821,31350
838,MAHDTech,3,0.00957,11464,36.56778,31350
839,maltegrosse,3,0.00957,11467,36.57735,31350
840,markbaumgarten,3,0.00957,11470,36.58692,31350
841,MarkusDressel,3,0.00957,11473,36.59649,31350
842,masshysteria1,3,0.00957,11476,36.60606,31350
843,mateuszkozakiewicz,3,0.00957,11479,36.61563,31350
844,Matroxt,3,0.00957,11482,36.62520,31350
845,matthew-a-dunlap,3,0.00957,11485,36.63477,31350
846,michalpie,3,0.00957,11488,36.64434,31350
847,michalsabol2,3,0.00957,11491,36.65391,31350
848,Mik317,3,0.00957,11494,36.66348,31350
849,mikailyetkin,3,0.00957,11497,36.67305,31350
850,MikeHingley22,3,0.00957,11500,36.68262,31350
851,mike-sirs,3,0.00957,11503,36.69219,31350
852,mik-laj,3,0.00957,11506,36.70175,31350
853,mirawara,3,0.00957,11509,36.71132,31350
854,miritsadon,3,0.00957,11512,36.72089,31350
855,mister-dj,3,0.00957,11515,36.73046,31350
856,mkontani,3,0.00957,11518,36.74003,31350
857,mleklund,3,0.00957,11521,36.74960,31350
858,mmmommm,3,0.00957,11524,36.75917,31350
859,moritzschmitz-oviva,3,0.00957,11527,36.76874,31350
860,MVJosh,3,0.00957,11530,36.77831,31350
861,MXfive,3,0.00957,11533,36.78788,31350
862,nbarlowATI,3,0.00957,11536,36.79745,31350
863,nicolasmanic,3,0.00957,11539,36.80702,31350
864,nirupbbnk,3,0.00957,11542,36.81659,31350
865,nodranael,3,0.00957,11545,36.82616,31350
866,Nojinverse,3,0.00957,11548,36.83573,31350
867,none0nfg,3,0.00957,11551,36.84530,31350
868,nonylene,3,0.00957,11554,36.85486,31350
869,noobadmin,3,0.00957,11557,36.86443,31350
870,olegblecher,3,0.00957,11560,36.87400,31350
871,ollie-nye,3,0.00957,11563,36.88357,31350
872,onixie,3,0.00957,11566,36.89314,31350
873,osimosu,3,0.00957,11569,36.90271,31350
874,panickeraj,3,0.00957,11572,36.91228,31350
875,pappavic,3,0.00957,11575,36.92185,31350
876,parth30,3,0.00957,11578,36.93142,31350
877,parttimer777,3,0.00957,11581,36.94099,31350
878,pathmissing,3,0.00957,11584,36.95056,31350
879,pettermk,3,0.00957,11587,36.96013,31350
880,philiplb,3,0.00957,11590,36.96970,31350
881,piyushk,3,0.00957,11593,36.97927,31350
882,pollier,3,0.00957,11596,36.98884,31350
883,ptimofee,3,0.00957,11599,36.99841,31350
884,puneetbabbar26,3,0.00957,11602,37.00797,31350
885,puneety95,3,0.00957,11605,37.01754,31350
886,Purneau,3,0.00957,11608,37.02711,31350
887,queueburt,3,0.00957,11611,37.03668,31350
888,rafaelfelix,3,0.00957,11614,37.04625,31350
889,ramkrivas,3,0.00957,11617,37.05582,31350
890,RaoulDijksman,3,0.00957,11620,37.06539,31350
891,raresociopath,3,0.00957,11623,37.07496,31350
892,Ravio1i,3,0.00957,11626,37.08453,31350
893,rbailly-talend,3,0.00957,11629,37.09410,31350
894,rdecuir,3,0.00957,11632,37.10367,31350
895,ReillyProcentive,3,0.00957,11635,37.11324,31350
896,Renizmy,3,0.00957,11638,37.12281,31350
897,rgarrigue,3,0.00957,11641,37.13238,31350
898,Richie765,3,0.00957,11644,37.14195,31350
899,richjyoung,3,0.00957,11647,37.15152,31350
900,rickrain,3,0.00957,11650,37.16108,31350
901,rkkris75,3,0.00957,11653,37.17065,31350
902,Robert-Dobry,3,0.00957,11656,37.18022,31350
903,Robin-Sch,3,0.00957,11659,37.18979,31350
904,RockRich,3,0.00957,11662,37.19936,31350
905,rogerscuall,3,0.00957,11665,37.20893,31350
906,rohrit,3,0.00957,11668,37.21850,31350
907,Rojax,3,0.00957,11671,37.22807,31350
908,ryjogo,3,0.00957,11674,37.23764,31350
909,sabinayakc,3,0.00957,11677,37.24721,31350
910,sasha-tooryani-sage,3,0.00957,11680,37.25678,31350
911,schuenen,3,0.00957,11683,37.26635,31350
912,sde-melo,3,0.00957,11686,37.27592,31350
913,seansaleh,3,0.00957,11689,37.28549,31350
914,seilersTNG,3,0.00957,11692,37.29506,31350
915,SilvioSodre,3,0.00957,11695,37.30463,31350
916,sim642,3,0.00957,11698,37.31419,31350
917,simeoncran,3,0.00957,11701,37.32376,31350
918,simeonlam,3,0.00957,11704,37.33333,31350
919,SimonMisencik,3,0.00957,11707,37.34290,31350
920,sindre-nistad,3,0.00957,11710,37.35247,31350
921,sitaramkm,3,0.00957,11713,37.36204,31350
922,smiziara,3,0.00957,11716,37.37161,31350
923,snigdha920,3,0.00957,11719,37.38118,31350
924,snoopyCode,3,0.00957,11722,37.39075,31350
925,speedythesnailnpg,3,0.00957,11725,37.40032,31350
926,spprod35,3,0.00957,11728,37.40989,31350
927,srekkas,3,0.00957,11731,37.41946,31350
928,sstidl,3,0.00957,11734,37.42903,31350
929,sTb1337,3,0.00957,11737,37.43860,31350
930,stedaniels,3,0.00957,11740,37.44817,31350
931,StephenOTT,3,0.00957,11743,37.45774,31350
932,stleon,3,0.00957,11746,37.46730,31350
933,suzuryo97,3,0.00957,11749,37.47687,31350
934,sybereal,3,0.00957,11752,37.48644,31350
935,tasiorek27,3,0.00957,11755,37.49601,31350
936,Taurophylax,3,0.00957,11758,37.50558,31350
937,tejas-sme,3,0.00957,11761,37.51515,31350
938,tg44,3,0.00957,11764,37.52472,31350
939,theanhdh,3,0.00957,11767,37.53429,31350
940,thefaftek-git,3,0.00957,11770,37.54386,31350
941,theodotos,3,0.00957,11773,37.55343,31350
942,timyong80,3,0.00957,11776,37.56300,31350
943,toddke,3,0.00957,11779,37.57257,31350
944,TonyInTokyo,3,0.00957,11782,37.58214,31350
945,torsrex,3,0.00957,11785,37.59171,31350
946,travisofthenorth,3,0.00957,11788,37.60128,31350
947,trevorbox,3,0.00957,11791,37.61085,31350
948,tunkandroll,3,0.00957,11794,37.62041,31350
949,T-vK,3,0.00957,11797,37.62998,31350
950,tybulewicz,3,0.00957,11800,37.63955,31350
951,utix,3,0.00957,11803,37.64912,31350
952,utkuturunc,3,0.00957,11806,37.65869,31350
953,v01d-bak3r,3,0.00957,11809,37.66826,31350
954,vangahari,3,0.00957,11812,37.67783,31350
955,vidaks,3,0.00957,11815,37.68740,31350
956,WestFarmer,3,0.00957,11818,37.69697,31350
957,Whyeasy,3,0.00957,11821,37.70654,31350
958,xellsys,3,0.00957,11824,37.71611,31350
959,xtha,3,0.00957,11827,37.72568,31350
960,xXluki98Xx,3,0.00957,11830,37.73525,31350
961,xynova,3,0.00957,11833,37.74482,31350
962,yene,3,0.00957,11836,37.75439,31350
963,yeplaa,3,0.00957,11839,37.76396,31350
964,yoshixmk,3,0.00957,11842,37.77352,31350
965,y-tag,3,0.00957,11845,37.78309,31350
966,yuanqiuye,3,0.00957,11848,37.79266,31350
967,zfrhv,3,0.00957,11851,37.80223,31350
968,zhengyang1988,3,0.00957,11854,37.81180,31350
969,zvazquez,3,0.00957,11857,37.82137,31350
970,3cham,2,0.00638,11859,37.82775,31350
971,aagarwal-opendoor,2,0.00638,11861,37.83413,31350
972,aas47,2,0.00638,11863,37.84051,31350
973,abel-workera,2,0.00638,11865,37.84689,31350
974,adamcstephens,2,0.00638,11867,37.85327,31350
975,adarsh-ks,2,0.00638,11869,37.85965,31350
976,adlnc,2,0.00638,11871,37.86603,31350
977,adrianwebb,2,0.00638,11873,37.87241,31350
978,adrillon,2,0.00638,11875,37.87879,31350
979,afabiani,2,0.00638,11877,37.88517,31350
980,Aishwer-chegg,2,0.00638,11879,37.89155,31350
981,aliktb,2,0.00638,11881,37.89793,31350
982,alternaivan,2,0.00638,11883,37.90431,31350
983,amitkatyal,2,0.00638,11885,37.91069,31350
984,andor0,2,0.00638,11887,37.91707,31350
985,andreas-p,2,0.00638,11889,37.92344,31350
986,andrebarrett,2,0.00638,11891,37.92982,31350
987,andrescolodrero,2,0.00638,11893,37.93620,31350
988,andrevdh,2,0.00638,11895,37.94258,31350
989,andrew-gropyus,2,0.00638,11897,37.94896,31350
990,andrewkcarter,2,0.00638,11899,37.95534,31350
991,AndrewNiven1,2,0.00638,11901,37.96172,31350
992,anetbnd,2,0.00638,11903,37.96810,31350
993,Anonymous-Coward,2,0.00638,11905,37.97448,31350
994,anyname2,2,0.00638,11907,37.98086,31350
995,arnoldfranz,2,0.00638,11909,37.98724,31350
996,arshia-shakudo,2,0.00638,11911,37.99362,31350
997,artyomtkachenko,2,0.00638,11913,38.00000,31350
998,aseemmishra25,2,0.00638,11915,38.00638,31350
999,ataraxus,2,0.00638,11917,38.01276,31350
1000,avarf,2,0.00638,11919,38.01914,31350
1001,avtarOPS,2,0.00638,11921,38.02552,31350
1002,awoimbee,2,0.00638,11923,38.03190,31350
1003,axl8713,2,0.00638,11925,38.03828,31350
1004,ayavin,2,0.00638,11927,38.04466,31350
1005,balazsjdp,2,0.00638,11929,38.05104,31350
1006,bayerlse,2,0.00638,11931,38.05742,31350
1007,bchess,2,0.00638,11933,38.06380,31350
1008,bck01215,2,0.00638,11935,38.07018,31350
1009,bendlas,2,0.00638,11937,38.07656,31350
1010,benedikt-mue,2,0.00638,11939,38.08293,31350
1011,benjaminejarrell,2,0.00638,11941,38.08931,31350
1012,BenjaminHae,2,0.00638,11943,38.09569,31350
1013,Bewalticus,2,0.00638,11945,38.10207,31350
1014,bgoldiing,2,0.00638,11947,38.10845,31350
1015,bhallionOhbibi,2,0.00638,11949,38.11483,31350
1016,Bigouden,2,0.00638,11951,38.12121,31350
1017,blockchainunchained,2,0.00638,11953,38.12759,31350
1018,Bluston,2,0.00638,11955,38.13397,31350
1019,bobykus31,2,0.00638,11957,38.14035,31350
1020,bohrasd,2,0.00638,11959,38.14673,31350
1021,boutobza,2,0.00638,11961,38.15311,31350
1022,brucke,2,0.00638,11963,38.15949,31350
1023,Burya94,2,0.00638,11965,38.16587,31350
1024,C0rn3j,2,0.00638,11967,38.17225,31350
1025,CaptInsano,2,0.00638,11969,38.17863,31350
1026,cccsss01,2,0.00638,11971,38.18501,31350
1027,cdanis,2,0.00638,11973,38.19139,31350
1028,celesteormaechea,2,0.00638,11975,38.19777,31350
1029,charbonnierg,2,0.00638,11977,38.20415,31350
1030,christidis,2,0.00638,11979,38.21053,31350
1031,chuegel,2,0.00638,11981,38.21691,31350
1032,clement-igonet,2,0.00638,11983,38.22329,31350
1033,cmenzi,2,0.00638,11985,38.22967,31350
1034,code-acc1,2,0.00638,11987,38.23604,31350
1035,code-and-such,2,0.00638,11989,38.24242,31350
1036,craftbyte,2,0.00638,11991,38.24880,31350
1037,danbrad,2,0.00638,11993,38.25518,31350
1038,danieldietrichriverty,2,0.00638,11995,38.26156,31350
1039,dannyyy,2,0.00638,11997,38.26794,31350
1040,davidparks21,2,0.00638,11999,38.27432,31350
1041,dcomas,2,0.00638,12001,38.28070,31350
1042,deanm0000,2,0.00638,12003,38.28708,31350
1043,deepakdeore2004,2,0.00638,12005,38.29346,31350
1044,DesalLama,2,0.00638,12007,38.29984,31350
1045,detlevvandaele-tomtom,2,0.00638,12009,38.30622,31350
1046,DeviaVir,2,0.00638,12011,38.31260,31350
1047,devon-mar,2,0.00638,12013,38.31898,31350
1048,dextercai,2,0.00638,12015,38.32536,31350
1049,dgivens,2,0.00638,12017,38.33174,31350
1050,dhardy92,2,0.00638,12019,38.33812,31350
1051,dhm-msd,2,0.00638,12021,38.34450,31350
1052,DimitryVo,2,0.00638,12023,38.35088,31350
1053,dingo15,2,0.00638,12025,38.35726,31350
1054,djarillo,2,0.00638,12027,38.36364,31350
1055,djfinlay,2,0.00638,12029,38.37002,31350
1056,dkutetsky,2,0.00638,12031,38.37640,31350
1057,d-led,2,0.00638,12033,38.38278,31350
1058,dmitriypavlov,2,0.00638,12035,38.38915,31350
1059,domenzain,2,0.00638,12037,38.39553,31350
1060,dreadnought,2,0.00638,12039,38.40191,31350
1061,DreamingRaven,2,0.00638,12041,38.40829,31350
1062,d-theus,2,0.00638,12043,38.41467,31350
1063,eabud,2,0.00638,12045,38.42105,31350
1064,edwardzjl,2,0.00638,12047,38.42743,31350
1065,Electrofenster,2,0.00638,12049,38.43381,31350
1066,elkh510,2,0.00638,12051,38.44019,31350
1067,emjay010,2,0.00638,12053,38.44657,31350
1068,empperi,2,0.00638,12055,38.45295,31350
1069,emrobe,2,0.00638,12057,38.45933,31350
1070,Enryah,2,0.00638,12059,38.46571,31350
1071,entersb,2,0.00638,12061,38.47209,31350
1072,euhansen,2,0.00638,12063,38.47847,31350
1073,Everluis58,2,0.00638,12065,38.48485,31350
1074,evgenstein,2,0.00638,12067,38.49123,31350
1075,EvilMcJerkface,2,0.00638,12069,38.49761,31350
1076,evozniak,2,0.00638,12071,38.50399,31350
1077,ezawadzki,2,0.00638,12073,38.51037,31350
1078,fabian-ifflaender-triveme,2,0.00638,12075,38.51675,31350
1079,fabio-s-franco,2,0.00638,12077,38.52313,31350
1080,fauziyasin,2,0.00638,12079,38.52951,31350
1081,fcomte,2,0.00638,12081,38.53589,31350
1082,federicobarera,2,0.00638,12083,38.54226,31350
1083,ffma-glen-sampson,2,0.00638,12085,38.54864,31350
1084,fiammaz,2,0.00638,12087,38.55502,31350
1085,fishfree,2,0.00638,12089,38.56140,31350
1086,fjrial,2,0.00638,12091,38.56778,31350
1087,flechaig,2,0.00638,12093,38.57416,31350
1088,Flo0806,2,0.00638,12095,38.58054,31350
1089,fluzzykitten,2,0.00638,12097,38.58692,31350
1090,francoisblin,2,0.00638,12099,38.59330,31350
1091,franco-viotti,2,0.00638,12101,38.59968,31350
1092,fredlb,2,0.00638,12103,38.60606,31350
1093,fsegouin,2,0.00638,12105,38.61244,31350
1094,fuchst,2,0.00638,12107,38.61882,31350
1095,fungalcofe,2,0.00638,12109,38.62520,31350
1096,gauravshah22,2,0.00638,12111,38.63158,31350
1097,gaveezy,2,0.00638,12113,38.63796,31350
1098,gcaracuel,2,0.00638,12115,38.64434,31350
1099,gchait,2,0.00638,12117,38.65072,31350
1100,gchappell99,2,0.00638,12119,38.65710,31350
1101,georgewfisher,2,0.00638,12121,38.66348,31350
1102,GFlo69,2,0.00638,12123,38.66986,31350
1103,ghermana,2,0.00638,12125,38.67624,31350
1104,gigabyte132,2,0.00638,12127,38.68262,31350
1105,glebsts,2,0.00638,12129,38.68900,31350
1106,gogovan-vincentngai,2,0.00638,12131,38.69537,31350
1107,gosho-fsx,2,0.00638,12133,38.70175,31350
1108,gregmuellegger,2,0.00638,12135,38.70813,31350
1109,gygabyte017,2,0.00638,12137,38.71451,31350
1110,gyson,2,0.00638,12139,38.72089,31350
1111,haglo,2,0.00638,12141,38.72727,31350
1112,heiniham,2,0.00638,12143,38.73365,31350
1113,HeneryHawk,2,0.00638,12145,38.74003,31350
1114,henriknil,2,0.00638,12147,38.74641,31350
1115,himanshujaindev,2,0.00638,12149,38.75279,31350
1116,hiseth,2,0.00638,12151,38.75917,31350
1117,hlhendy,2,0.00638,12153,38.76555,31350
1118,hmshashank,2,0.00638,12155,38.77193,31350
1119,Hosted-EU,2,0.00638,12157,38.77831,31350
1120,htpawel,2,0.00638,12159,38.78469,31350
1121,hunterboerner,2,0.00638,12161,38.79107,31350
1122,iamaverrick,2,0.00638,12163,38.79745,31350
1123,ilyakooo0,2,0.00638,12165,38.80383,31350
1124,indranilr,2,0.00638,12167,38.81021,31350
1125,InSpectre6,2,0.00638,12169,38.81659,31350
1126,jaakkom,2,0.00638,12171,38.82297,31350
1127,JackLThornton,2,0.00638,12173,38.82935,31350
1128,jagan1333,2,0.00638,12175,38.83573,31350
1129,jahveen,2,0.00638,12177,38.84211,31350
1130,jakajancar,2,0.00638,12179,38.84848,31350
1131,janbaer,2,0.00638,12181,38.85486,31350
1132,janrotter,2,0.00638,12183,38.86124,31350
1133,janssen92,2,0.00638,12185,38.86762,31350
1134,japneet-sahni,2,0.00638,12187,38.87400,31350
1135,JasperWoo,2,0.00638,12189,38.88038,31350
1136,jawscout,2,0.00638,12191,38.88676,31350
1137,jbolus-nifc,2,0.00638,12193,38.89314,31350
1138,jchenship,2,0.00638,12195,38.89952,31350
1139,jcz1,2,0.00638,12197,38.90590,31350
1140,jdbranham,2,0.00638,12199,38.91228,31350
1141,jeffersonbabuyo,2,0.00638,12201,38.91866,31350
1142,jeffisabelle,2,0.00638,12203,38.92504,31350
1143,jerome-blanche,2,0.00638,12205,38.93142,31350
1144,jessicabarbalho,2,0.00638,12207,38.93780,31350
1145,jflo93,2,0.00638,12209,38.94418,31350
1146,jimethn,2,0.00638,12211,38.95056,31350
1147,jimrobinson,2,0.00638,12213,38.95694,31350
1148,JindrichD,2,0.00638,12215,38.96332,31350
1149,JirCe,2,0.00638,12217,38.96970,31350
1150,jlore-talend,2,0.00638,12219,38.97608,31350
1151,jmahlik,2,0.00638,12221,38.98246,31350
1152,jmarginier,2,0.00638,12223,38.98884,31350
1153,jmfrank63,2,0.00638,12225,38.99522,31350
1154,joel-bluedata,2,0.00638,12227,39.00159,31350
1155,JohnPadgettCivica,2,0.00638,12229,39.00797,31350
1156,jon88,2,0.00638,12231,39.01435,31350
1157,JonathanMbt,2,0.00638,12233,39.02073,31350
1158,JoniJnm,2,0.00638,12235,39.02711,31350
1159,josephcf,2,0.00638,12237,39.03349,31350
1160,jowi24,2,0.00638,12239,39.03987,31350
1161,jpc,2,0.00638,12241,39.04625,31350
1162,Jude188,2,0.00638,12243,39.05263,31350
1163,juliangums,2,0.00638,12245,39.05901,31350
1164,kalid189181,2,0.00638,12247,39.06539,31350
1165,kanekikeys,2,0.00638,12249,39.07177,31350
1166,karatkep,2,0.00638,12251,39.07815,31350
1167,karel1980,2,0.00638,12253,39.08453,31350
1168,karpoftea,2,0.00638,12255,39.09091,31350
1169,kawatatsu0924,2,0.00638,12257,39.09729,31350
1170,keachi,2,0.00638,12259,39.10367,31350
1171,kereis,2,0.00638,12261,39.11005,31350
1172,kernelcoredump,2,0.00638,12263,39.11643,31350
1173,kforner,2,0.00638,12265,39.12281,31350
1174,Kidoly,2,0.00638,12267,39.12919,31350
1175,kodeine,2,0.00638,12269,39.13557,31350
1176,kolbitsch-lastline,2,0.00638,12271,39.14195,31350
1177,korporationcl,2,0.00638,12273,39.14833,31350
1178,koter84,2,0.00638,12275,39.15470,31350
1179,kumekay,2,0.00638,12277,39.16108,31350
1180,kyleli666,2,0.00638,12279,39.16746,31350
1181,Kyserbyte,2,0.00638,12281,39.17384,31350
1182,ladislavrolnik,2,0.00638,12283,39.18022,31350
1183,lasith011,2,0.00638,12285,39.18660,31350
1184,lieryan,2,0.00638,12287,39.19298,31350
1185,ljluestc,2,0.00638,12289,39.19936,31350
1186,Llewellin,2,0.00638,12291,39.20574,31350
1187,llomgui,2,0.00638,12293,39.21212,31350
1188,lmm-git,2,0.00638,12295,39.21850,31350
1189,lnvn,2,0.00638,12297,39.22488,31350
1190,lolllpop,2,0.00638,12299,39.23126,31350
1191,lollo25,2,0.00638,12301,39.23764,31350
1192,lucasrf,2,0.00638,12303,39.24402,31350
1193,LucidoKeith,2,0.00638,12305,39.25040,31350
1194,lukaszbandi,2,0.00638,12307,39.25678,31350
1195,lukemaslany-next,2,0.00638,12309,39.26316,31350
1196,m4123,2,0.00638,12311,39.26954,31350
1197,madhusudhannr,2,0.00638,12313,39.27592,31350
1198,maietta,2,0.00638,12315,39.28230,31350
1199,marbon87,2,0.00638,12317,39.28868,31350
1200,mariannovotny,2,0.00638,12319,39.29506,31350
1201,mariusmarais,2,0.00638,12321,39.30144,31350
1202,mathewcristo,2,0.00638,12323,39.30781,31350
1203,Math-Lang,2,0.00638,12325,39.31419,31350
1204,matiasgarciaisaia,2,0.00638,12327,39.32057,31350
1205,MaximusVasilenko,2,0.00638,12329,39.32695,31350
1206,mdgilene,2,0.00638,12331,39.33333,31350
1207,mdreem,2,0.00638,12333,39.33971,31350
1208,meastman,2,0.00638,12335,39.34609,31350
1209,MeisterGig,2,0.00638,12337,39.35247,31350
1210,mhktc,2,0.00638,12339,39.35885,31350
1211,mhlyak,2,0.00638,12341,39.36523,31350
1212,mhsraft,2,0.00638,12343,39.37161,31350
1213,Michael-Tang-2009,2,0.00638,12345,39.37799,31350
1214,mildis,2,0.00638,12347,39.38437,31350
1215,mkauzlar,2,0.00638,12349,39.39075,31350
1216,moolex,2,0.00638,12351,39.39713,31350
1217,mr-ma,2,0.00638,12353,39.40351,31350
1218,mrnim94,2,0.00638,12355,39.40989,31350
1219,msimin-asapp,2,0.00638,12357,39.41627,31350
1220,mteubner,2,0.00638,12359,39.42265,31350
1221,myifeng,2,0.00638,12361,39.42903,31350
1222,nawa,2,0.00638,12363,39.43541,31350
1223,neetupm13,2,0.00638,12365,39.44179,31350
1224,nehap4,2,0.00638,12367,39.44817,31350
1225,nemzes,2,0.00638,12369,39.45455,31350
1226,netmikey,2,0.00638,12371,39.46093,31350
1227,newcron,2,0.00638,12373,39.46730,31350
1228,nhahn1312,2,0.00638,12375,39.47368,31350
1229,nielsn,2,0.00638,12377,39.48006,31350
1230,niklasgrewe,2,0.00638,12379,39.48644,31350
1231,nishafnaeem,2,0.00638,12381,39.49282,31350
1232,nniikkoollaaii,2,0.00638,12383,39.49920,31350
1233,ntx-ben,2,0.00638,12385,39.50558,31350
1234,ObjectivelyAj,2,0.00638,12387,39.51196,31350
1235,oe06,2,0.00638,12389,39.51834,31350
1236,Olcod,2,0.00638,12391,39.52472,31350
1237,oliver-goetz,2,0.00638,12393,39.53110,31350
1238,OmarHawk,2,0.00638,12395,39.53748,31350
1239,OmAximani0,2,0.00638,12397,39.54386,31350
1240,omnibrain,2,0.00638,12399,39.55024,31350
1241,ooraini,2,0.00638,12401,39.55662,31350
1242,PacketShepard,2,0.00638,12403,39.56300,31350
1243,pacoja84,2,0.00638,12405,39.56938,31350
1244,PaleNeutron,2,0.00638,12407,39.57576,31350
1245,PAStheLoD,2,0.00638,12409,39.58214,31350
1246,paulbrittain,2,0.00638,12411,39.58852,31350
1247,pauloalexandre3d,2,0.00638,12413,39.59490,31350
1248,paulocuambe,2,0.00638,12415,39.60128,31350
1249,paulpuvi06,2,0.00638,12417,39.60766,31350
1250,pavan-pn,2,0.00638,12419,39.61404,31350
1251,pawgajda-drs,2,0.00638,12421,39.62041,31350
1252,PengtaoNing,2,0.00638,12423,39.62679,31350
1253,phongpg284,2,0.00638,12425,39.63317,31350
1254,pinkavaj,2,0.00638,12427,39.63955,31350
1255,pkking,2,0.00638,12429,39.64593,31350
1256,popsiclexu,2,0.00638,12431,39.65231,31350
1257,ppawiggers,2,0.00638,12433,39.65869,31350
1258,prabhapa,2,0.00638,12435,39.66507,31350
1259,prakashmirji,2,0.00638,12437,39.67145,31350
1260,prancer71,2,0.00638,12439,39.67783,31350
1261,prikshitsetia,2,0.00638,12441,39.68421,31350
1262,przemub,2,0.00638,12443,39.69059,31350
1263,pushkyn,2,0.00638,12445,39.69697,31350
1264,qkflies,2,0.00638,12447,39.70335,31350
1265,Raskosk,2,0.00638,12449,39.70973,31350
1266,RaymondPhilips,2,0.00638,12451,39.71611,31350
1267,reedloden,2,0.00638,12453,39.72249,31350
1268,regicsolutions,2,0.00638,12455,39.72887,31350
1269,rendicott,2,0.00638,12457,39.73525,31350
1270,reschandreas,2,0.00638,12459,39.74163,31350
1271,rhuddleston,2,0.00638,12461,39.74801,31350
1272,ricardo-mestre,2,0.00638,12463,39.75439,31350
1273,rickfleming,2,0.00638,12465,39.76077,31350
1274,rkimmel-hv,2,0.00638,12467,39.76715,31350
1275,rnsc,2,0.00638,12469,39.77352,31350
1276,robertmuth,2,0.00638,12471,39.77990,31350
1277,robertocamp,2,0.00638,12473,39.78628,31350
1278,roderik,2,0.00638,12475,39.79266,31350
1279,Rohlik,2,0.00638,12477,39.79904,31350
1280,romanGarvis,2,0.00638,12479,39.80542,31350
1281,romanpanov993,2,0.00638,12481,39.81180,31350
1282,rowi1de,2,0.00638,12483,39.81818,31350
1283,Roymprog,2,0.00638,12485,39.82456,31350
1284,royxact,2,0.00638,12487,39.83094,31350
1285,rusakov92,2,0.00638,12489,39.83732,31350
1286,rveve,2,0.00638,12491,39.84370,31350
1287,ryuichi1208,2,0.00638,12493,39.85008,31350
1288,s1apped,2,0.00638,12495,39.85646,31350
1289,saemideluxe,2,0.00638,12497,39.86284,31350
1290,SamStephens,2,0.00638,12499,39.86922,31350
1291,samuelleb11,2,0.00638,12501,39.87560,31350
1292,sansarpoudel,2,0.00638,12503,39.88198,31350
1293,satr,2,0.00638,12505,39.88836,31350
1294,satyamkapoor,2,0.00638,12507,39.89474,31350
1295,satyamsundaram,2,0.00638,12509,39.90112,31350
1296,scaamanho,2,0.00638,12511,39.90750,31350
1297,Scrumplex,2,0.00638,12513,39.91388,31350
1298,selamanse,2,0.00638,12515,39.92026,31350
1299,sharkymcdongles,2,0.00638,12517,39.92663,31350
1300,shubhamdeodia,2,0.00638,12519,39.93301,31350
1301,shuesken,2,0.00638,12521,39.93939,31350
1302,Sierra1011,2,0.00638,12523,39.94577,31350
1303,simon04,2,0.00638,12525,39.95215,31350
1304,simon-eon,2,0.00638,12527,39.95853,31350
1305,ski7777,2,0.00638,12529,39.96491,31350
1306,SlackingVeteran,2,0.00638,12531,39.97129,31350
1307,slashlinux,2,0.00638,12533,39.97767,31350
1308,slvic,2,0.00638,12535,39.98405,31350
1309,smarshal-Quest,2,0.00638,12537,39.99043,31350
1310,smehboub,2,0.00638,12539,39.99681,31350
1311,smerschjohann,2,0.00638,12541,40.00319,31350
1312,sMteX,2,0.00638,12543,40.00957,31350
1313,Smuger,2,0.00638,12545,40.01595,31350
1314,snowjet,2,0.00638,12547,40.02233,31350
1315,someonewating,2,0.00638,12549,40.02871,31350
1316,SooOverpowered,2,0.00638,12551,40.03509,31350
1317,spamokm,2,0.00638,12553,40.04147,31350
1318,spanner-uk,2,0.00638,12555,40.04785,31350
1319,sshepel,2,0.00638,12557,40.05423,31350
1320,stippi,2,0.00638,12559,40.06061,31350
1321,stoetti,2,0.00638,12561,40.06699,31350
1322,SuperSandro2000,2,0.00638,12563,40.07337,31350
1323,sw506,2,0.00638,12565,40.07974,31350
1324,Swetad90,2,0.00638,12567,40.08612,31350
1325,T2brozz,2,0.00638,12569,40.09250,31350
1326,TamasNeumer,2,0.00638,12571,40.09888,31350
1327,tambetliiv,2,0.00638,12573,40.10526,31350
1328,tatianaschaefer0815,2,0.00638,12575,40.11164,31350
1329,tberreis,2,0.00638,12577,40.11802,31350
1330,teodor-pripoae,2,0.00638,12579,40.12440,31350
1331,th30nlyw4y,2,0.00638,12581,40.13078,31350
1332,thapabishwa,2,0.00638,12583,40.13716,31350
1333,thecanadianroot,2,0.00638,12585,40.14354,31350
1334,thedmi,2,0.00638,12587,40.14992,31350
1335,TheImplementer,2,0.00638,12589,40.15630,31350
1336,theredcat,2,0.00638,12591,40.16268,31350
1337,Thesola10,2,0.00638,12593,40.16906,31350
1338,thisisfeature,2,0.00638,12595,40.17544,31350
1339,ThomasBoutry,2,0.00638,12597,40.18182,31350
1340,timgoud,2,0.00638,12599,40.18820,31350
1341,tionis,2,0.00638,12601,40.19458,31350
1342,tmurphy5,2,0.00638,12603,40.20096,31350
1343,Tommy-Her,2,0.00638,12605,40.20734,31350
1344,tomoyk,2,0.00638,12607,40.21372,31350
1345,tonyupup,2,0.00638,12609,40.22010,31350
1346,torrybr,2,0.00638,12611,40.22648,31350
1347,trel,2,0.00638,12613,40.23285,31350
1348,trettstadtnlb,2,0.00638,12615,40.23923,31350
1349,TrevorOchmonek,2,0.00638,12617,40.24561,31350
1350,turbotankist,2,0.00638,12619,40.25199,31350
1351,twitchyliquid64,2,0.00638,12621,40.25837,31350
1352,umeshkaul,2,0.00638,12623,40.26475,31350
1353,urbaniak,2,0.00638,12625,40.27113,31350
1354,v7lin,2,0.00638,12627,40.27751,31350
1355,valen7in,2,0.00638,12629,40.28389,31350
1356,vdbulcke,2,0.00638,12631,40.29027,31350
1357,Venky4u,2,0.00638,12633,40.29665,31350
1358,vetinari,2,0.00638,12635,40.30303,31350
1359,virusdave,2,0.00638,12637,40.30941,31350
1360,vllvll,2,0.00638,12639,40.31579,31350
1361,WangYiDFO,2,0.00638,12641,40.32217,31350
1362,WareJosephB,2,0.00638,12643,40.32855,31350
1363,watterm,2,0.00638,12645,40.33493,31350
1364,wearpants,2,0.00638,12647,40.34131,31350
1365,western24,2,0.00638,12649,40.34769,31350
1366,Wildcarde,2,0.00638,12651,40.35407,31350
1367,will-0,2,0.00638,12653,40.36045,31350
1368,woodie,2,0.00638,12655,40.36683,31350
1369,wthrbtn,2,0.00638,12657,40.37321,31350
1370,wyewata,2,0.00638,12659,40.37959,31350
1371,Wykiki,2,0.00638,12661,40.38596,31350
1372,xcrementomaximum,2,0.00638,12663,40.39234,31350
1373,Xwaffle1,2,0.00638,12665,40.39872,31350
1374,yananielsen,2,0.00638,12667,40.40510,31350
1375,yevgeniy-ds,2,0.00638,12669,40.41148,31350
1376,ym,2,0.00638,12671,40.41786,31350
1377,ymuichiro,2,0.00638,12673,40.42424,31350
1378,YoitoFes,2,0.00638,12675,40.43062,31350
1379,yousri-meftah,2,0.00638,12677,40.43700,31350
1380,yrock,2,0.00638,12679,40.44338,31350
1381,YvannPONCE,2,0.00638,12681,40.44976,31350
1382,zarkoc,2,0.00638,12683,40.45614,31350
1383,zeisich,2,0.00638,12685,40.46252,31350
1384,zeroward,2,0.00638,12687,40.46890,31350
1385,zfalen-deloitte,2,0.00638,12689,40.47528,31350
1386,zhouxlt,2,0.00638,12691,40.48166,31350
1387,zltl,2,0.00638,12693,40.48804,31350
1388,01dregen,1,0.00319,12694,40.49123,31350
1389,0x0dr1y,1,0.00319,12695,40.49442,31350
1390,303snowing,1,0.00319,12696,40.49761,31350
1391,3213-cmd,1,0.00319,12697,40.50080,31350
1392,3e-maciej,1,0.00319,12698,40.50399,31350
1393,5331k,1,0.00319,12699,40.50718,31350
1394,59977,1,0.00319,12700,40.51037,31350
1395,76159482,1,0.00319,12701,40.51356,31350
1396,8snit,1,0.00319,12702,40.51675,31350
1397,aamberliu,1,0.00319,12703,40.51994,31350
1398,aamsur-933,1,0.00319,12704,40.52313,31350
1399,aarontavio,1,0.00319,12705,40.52632,31350
1400,aaschmid,1,0.00319,12706,40.52951,31350
1401,abdullahkhawer,1,0.00319,12707,40.53270,31350
1402,abdutta,1,0.00319,12708,40.53589,31350
1403,achaikaJH,1,0.00319,12709,40.53907,31350
1404,achimgrimm,1,0.00319,12710,40.54226,31350
1405,acidbotmaker,1,0.00319,12711,40.54545,31350
1406,adamaziz15,1,0.00319,12712,40.54864,31350
1407,adithyagokhale,1,0.00319,12713,40.55183,31350
1408,aditya142003,1,0.00319,12714,40.55502,31350
1409,aditya-appperfect,1,0.00319,12715,40.55821,31350
1410,adjenks,1,0.00319,12716,40.56140,31350
1411,ADN182,1,0.00319,12717,40.56459,31350
1412,adombrovsky,1,0.00319,12718,40.56778,31350
1413,adrdra,1,0.00319,12719,40.57097,31350
1414,aellwein,1,0.00319,12720,40.57416,31350
1415,Aerion,1,0.00319,12721,40.57735,31350
1416,agordon,1,0.00319,12722,40.58054,31350
1417,air5551,1,0.00319,12723,40.58373,31350
1418,Aishwarya-Murahari,1,0.00319,12724,40.58692,31350
1419,ajcollett,1,0.00319,12725,40.59011,31350
1420,aj-saini,1,0.00319,12726,40.59330,31350
1421,ajvpot,1,0.00319,12727,40.59649,31350
1422,akosveres,1,0.00319,12728,40.59968,31350
1423,akri16,1,0.00319,12729,40.60287,31350
1424,aksrocks2015,1,0.00319,12730,40.60606,31350
1425,aleksandrovpa,1,0.00319,12731,40.60925,31350
1426,alex0ptr,1,0.00319,12732,40.61244,31350
1427,Alexander-ac,1,0.00319,12733,40.61563,31350
1428,alexander-mayr-meister,1,0.00319,12734,40.61882,31350
1429,alexdanilowicz,1,0.00319,12735,40.62201,31350
1430,alexeytokar,1,0.00319,12736,40.62520,31350
1431,alexrandaccio,1,0.00319,12737,40.62839,31350
1432,AlexSins,1,0.00319,12738,40.63158,31350
1433,al-hy,1,0.00319,12739,40.63477,31350
1434,alperencelik,1,0.00319,12740,40.63796,31350
1435,alphabetek,1,0.00319,12741,40.64115,31350
1436,alsterg,1,0.00319,12742,40.64434,31350
1437,altane,1,0.00319,12743,40.64753,31350
1438,amanrao23,1,0.00319,12744,40.65072,31350
1439,AmansRevenger,1,0.00319,12745,40.65391,31350
1440,amiya-elear,1,0.00319,12746,40.65710,31350
1441,amlahoti,1,0.00319,12747,40.66029,31350
1442,amywampler6-oss,1,0.00319,12748,40.66348,31350
1443,andersonvcv,1,0.00319,12749,40.66667,31350
1444,andreas-geissler,1,0.00319,12750,40.66986,31350
1445,andreasgeisslerdt,1,0.00319,12751,40.67305,31350
1446,andrebreitenfeld,1,0.00319,12752,40.67624,31350
1447,AndreHenkel,1,0.00319,12753,40.67943,31350
1448,AndreLobato,1,0.00319,12754,40.68262,31350
1449,andrewconnors,1,0.00319,12755,40.68581,31350
1450,andriktr,1,0.00319,12756,40.68900,31350
1451,andriyvasylyna,1,0.00319,12757,40.69219,31350
1452,andycmaj,1,0.00319,12758,40.69537,31350
1453,angelmaturanat,1,0.00319,12759,40.69856,31350
1454,aniruddhshah27,1,0.00319,12760,40.70175,31350
1455,AnisimoffNikita,1,0.00319,12761,40.70494,31350
1456,ankense-cariad,1,0.00319,12762,40.70813,31350
1457,an-ky,1,0.00319,12763,40.71132,31350
1458,anshurajkaushik,1,0.00319,12764,40.71451,31350
1459,anthonymejia,1,0.00319,12765,40.71770,31350
1460,anthraxn8b,1,0.00319,12766,40.72089,31350
1461,antibios,1,0.00319,12767,40.72408,31350
1462,antoninrichard,1,0.00319,12768,40.72727,31350
1463,ap2k2,1,0.00319,12769,40.73046,31350
1464,apatil-nbs,1,0.00319,12770,40.73365,31350
1465,aqeelat,1,0.00319,12771,40.73684,31350
1466,aquam8,1,0.00319,12772,40.74003,31350
1467,aracnid,1,0.00319,12773,40.74322,31350
1468,arer-mf,1,0.00319,12774,40.74641,31350
1469,ArgTang,1,0.00319,12775,40.74960,31350
1470,aria1991,1,0.00319,12776,40.75279,31350
1471,ArkShocer,1,0.00319,12777,40.75598,31350
1472,arnouthoebreckx,1,0.00319,12778,40.75917,31350
1473,arpan2501,1,0.00319,12779,40.76236,31350
1474,arpitarathi,1,0.00319,12780,40.76555,31350
1475,arshiamalek,1,0.00319,12781,40.76874,31350
1476,artemiyokulov,1,0.00319,12782,40.77193,31350
1477,artificiosus,1,0.00319,12783,40.77512,31350
1478,asdil1991,1,0.00319,12784,40.77831,31350
1479,asharabu,1,0.00319,12785,40.78150,31350
1480,Ashish2712,1,0.00319,12786,40.78469,31350
1481,Ashitaka57,1,0.00319,12787,40.78788,31350
1482,ashp71,1,0.00319,12788,40.79107,31350
1483,astorath,1,0.00319,12789,40.79426,31350
1484,astronaut-chris,1,0.00319,12790,40.79745,31350
1485,asudhakarreddy,1,0.00319,12791,40.80064,31350
1486,asyd,1,0.00319,12792,40.80383,31350
1487,Atanas5,1,0.00319,12793,40.80702,31350
1488,atbentley,1,0.00319,12794,40.81021,31350
1489,atigyi,1,0.00319,12795,40.81340,31350
1490,atmosx,1,0.00319,12796,40.81659,31350
1491,atsu85,1,0.00319,12797,40.81978,31350
1492,atze234,1,0.00319,12798,40.82297,31350
1493,aug70,1,0.00319,12799,40.82616,31350
1494,AureaMohammadAlavi,1,0.00319,12800,40.82935,31350
1495,awill1988,1,0.00319,12801,40.83254,31350
1496,aXtionTim,1,0.00319,12802,40.83573,31350
1497,AxxlFoley,1,0.00319,12803,40.83892,31350
1498,AyanamiAkaha,1,0.00319,12804,40.84211,31350
1499,AzHicham,1,0.00319,12805,40.84530,31350
1500,b2ronn,1,0.00319,12806,40.84848,31350
1501,BaesKevin,1,0.00319,12807,40.85167,31350
1502,baez90,1,0.00319,12808,40.85486,31350
1503,Baibhav168,1,0.00319,12809,40.85805,31350
1504,bailsman,1,0.00319,12810,40.86124,31350
1505,bakhshb,1,0.00319,12811,40.86443,31350
1506,bangert,1,0.00319,12812,40.86762,31350
1507,beebird,1,0.00319,12813,40.87081,31350
1508,believerHSP,1,0.00319,12814,40.87400,31350
1509,benjroesner,1,0.00319,12815,40.87719,31350
1510,benoitgoujon,1,0.00319,12816,40.88038,31350
1511,ben-wallis,1,0.00319,12817,40.88357,31350
1512,benze,1,0.00319,12818,40.88676,31350
1513,BhautikChudasama,1,0.00319,12819,40.88995,31350
1514,bheem1992,1,0.00319,12820,40.89314,31350
1515,bhvr-fmarceau,1,0.00319,12821,40.89633,31350
1516,biclighter81,1,0.00319,12822,40.89952,31350
1517,bijay007,1,0.00319,12823,40.90271,31350
1518,bioshazard,1,0.00319,12824,40.90590,31350
1519,blankburian,1,0.00319,12825,40.90909,31350
1520,Blasterdick,1,0.00319,12826,40.91228,31350
1521,blsho,1,0.00319,12827,40.91547,31350
1522,BnJam,1,0.00319,12828,40.91866,31350
1523,bocDar5ter,1,0.00319,12829,40.92185,31350
1524,bogi788,1,0.00319,12830,40.92504,31350
1525,boolexp,1,0.00319,12831,40.92823,31350
1526,boomaker,1,0.00319,12832,40.93142,31350
1527,bo-quan,1,0.00319,12833,40.93461,31350
1528,bosch-ch,1,0.00319,12834,40.93780,31350
1529,bo-unitysvc,1,0.00319,12835,40.94099,31350
1530,bparquet,1,0.00319,12836,40.94418,31350
1531,bpatters,1,0.00319,12837,40.94737,31350
1532,br0ziliy,1,0.00319,12838,40.95056,31350
1533,brackend,1,0.00319,12839,40.95375,31350
1534,bradyfontenot,1,0.00319,12840,40.95694,31350
1535,Brawdunoir,1,0.00319,12841,40.96013,31350
1536,breizton,1,0.00319,12842,40.96332,31350
1537,brendon-stephens,1,0.00319,12843,40.96651,31350
1538,Brenton-Keats,1,0.00319,12844,40.96970,31350
1539,BrianHuf,1,0.00319,12845,40.97289,31350
1540,brjakab,1,0.00319,12846,40.97608,31350
1541,broekema41,1,0.00319,12847,40.97927,31350
1542,brumhard,1,0.00319,12848,40.98246,31350
1543,brunomartinspro,1,0.00319,12849,40.98565,31350
1544,BrynM,1,0.00319,12850,40.98884,31350
1545,Brzhk,1,0.00319,12851,40.99203,31350
1546,bt909,1,0.00319,12852,40.99522,31350
1547,BuddhaSource,1,0.00319,12853,40.99841,31350
1548,bulzipke,1,0.00319,12854,41.00159,31350
1549,burnedikt,1,0.00319,12855,41.00478,31350
1550,bushelofsilicon,1,0.00319,12856,41.00797,31350
1551,BusyBeeATais,1,0.00319,12857,41.01116,31350
1552,CallumWayve,1,0.00319,12858,41.01435,31350
1553,cameronbriar,1,0.00319,12859,41.01754,31350
1554,campbellhennessy,1,0.00319,12860,41.02073,31350
1555,canchanchara,1,0.00319,12861,41.02392,31350
1556,cardoppler,1,0.00319,12862,41.02711,31350
1557,CarlosDomingues,1,0.00319,12863,41.03030,31350
1558,cbbba18,1,0.00319,12864,41.03349,31350
1559,cclerget,1,0.00319,12865,41.03668,31350
1560,cclloyd,1,0.00319,12866,41.03987,31350
1561,celevra,1,0.00319,12867,41.04306,31350
1562,ch3rub1,1,0.00319,12868,41.04625,31350
1563,chananelb,1,0.00319,12869,41.04944,31350
1564,chan-nguyen,1,0.00319,12870,41.05263,31350
1565,ChathuraCloud,1,0.00319,12871,41.05582,31350
1566,ChenTitan49,1,0.00319,12872,41.05901,31350
1567,chessser,1,0.00319,12873,41.06220,31350
1568,ChevronTango,1,0.00319,12874,41.06539,31350
1569,ChinthapalliNikhithaChandana,1,0.00319,12875,41.06858,31350
1570,Chippiewill,1,0.00319,12876,41.07177,31350
1571,chlinwei,1,0.00319,12877,41.07496,31350
1572,ChrisEke,1,0.00319,12878,41.07815,31350
1573,ChrisHubinger,1,0.00319,12879,41.08134,31350
1574,chrisleekr,1,0.00319,12880,41.08453,31350
1575,christianmerges,1,0.00319,12881,41.08772,31350
1576,christophenoel,1,0.00319,12882,41.09091,31350
1577,chriszuercher,1,0.00319,12883,41.09410,31350
1578,cjalmeida,1,0.00319,12884,41.09729,31350
1579,CJavierSaldana,1,0.00319,12885,41.10048,31350
1580,cjmalloy,1,0.00319,12886,41.10367,31350
1581,cjmangAT,1,0.00319,12887,41.10686,31350
1582,cjvirtucio87,1,0.00319,12888,41.11005,31350
1583,ck3d,1,0.00319,12889,41.11324,31350
1584,clayauld,1,0.00319,12890,41.11643,31350
1585,clickersmudge,1,0.00319,12891,41.11962,31350
1586,Clintonio,1,0.00319,12892,41.12281,31350
1587,cloudpaldev,1,0.00319,12893,41.12600,31350
1588,cmanzi,1,0.00319,12894,41.12919,31350
1589,CMarcher-Ahuora,1,0.00319,12895,41.13238,31350
1590,cnect-automation,1,0.00319,12896,41.13557,31350
1591,codevally,1,0.00319,12897,41.13876,31350
1592,coffeetrap,1,0.00319,12898,41.14195,31350
1593,commercial-maw,1,0.00319,12899,41.14514,31350
1594,CoolCold,1,0.00319,12900,41.14833,31350
1595,coronabytes,1,0.00319,12901,41.15152,31350
1596,CoryHagerman,1,0.00319,12902,41.15470,31350
1597,costrouc,1,0.00319,12903,41.15789,31350
1598,coy2k,1,0.00319,12904,41.16108,31350
1599,cpatrickalves,1,0.00319,12905,41.16427,31350
1600,cpflaume,1,0.00319,12906,41.16746,31350
1601,cr1st1p,1,0.00319,12907,41.17065,31350
1602,craigbeat,1,0.00319,12908,41.17384,31350
1603,cristiansteib,1,0.00319,12909,41.17703,31350
1604,crumohr,1,0.00319,12910,41.18022,31350
1605,cskarby,1,0.00319,12911,41.18341,31350
1606,ctschubel,1,0.00319,12912,41.18660,31350
1607,cuberinooo,1,0.00319,12913,41.18979,31350
1608,cudneys,1,0.00319,12914,41.19298,31350
1609,cvockrodt,1,0.00319,12915,41.19617,31350
1610,cwyj,1,0.00319,12916,41.19936,31350
1611,cz3k,1,0.00319,12917,41.20255,31350
1612,czhujer,1,0.00319,12918,41.20574,31350
1613,daB0bby,1,0.00319,12919,41.20893,31350
1614,daniellienert,1,0.00319,12920,41.21212,31350
1615,daniel-pimenta-DME,1,0.00319,12921,41.21531,31350
1616,danifr,1,0.00319,12922,41.21850,31350
1617,danjo133,1,0.00319,12923,41.22169,31350
1618,danny-sevaro,1,0.00319,12924,41.22488,31350
1619,dasantonym,1,0.00319,12925,41.22807,31350
1620,DatNoHand,1,0.00319,12926,41.23126,31350
1621,davide-romanini-milkman,1,0.00319,12927,41.23445,31350
1622,davidfrickert,1,0.00319,12928,41.23764,31350
1623,DavidVaness,1,0.00319,12929,41.24083,31350
1624,davinwang,1,0.00319,12930,41.24402,31350
1625,dawidswiton,1,0.00319,12931,41.24721,31350
1626,daydy16,1,0.00319,12932,41.25040,31350
1627,dbg-raghulkrishna,1,0.00319,12933,41.25359,31350
1628,dcardozoo,1,0.00319,12934,41.25678,31350
1629,dcarrion87,1,0.00319,12935,41.25997,31350
1630,dchandekstark,1,0.00319,12936,41.26316,31350
1631,dchen05,1,0.00319,12937,41.26635,31350
1632,deekshith-elear,1,0.00319,12938,41.26954,31350
1633,DelfiGhazaleh,1,0.00319,12939,41.27273,31350
1634,Denguido,1,0.00319,12940,41.27592,31350
1635,dennisbrouwer91,1,0.00319,12941,41.27911,31350
1636,derekkite,1,0.00319,12942,41.28230,31350
1637,derigel23,1,0.00319,12943,41.28549,31350
1638,deskoh,1,0.00319,12944,41.28868,31350
1639,desmondyeoh,1,0.00319,12945,41.29187,31350
1640,dev-rowbot,1,0.00319,12946,41.29506,31350
1641,dhananjay-bahal,1,0.00319,12947,41.29825,31350
1642,dietzsch,1,0.00319,12948,41.30144,31350
1643,dillfrescott,1,0.00319,12949,41.30463,31350
1644,dineshkoppa,1,0.00319,12950,41.30781,31350
1645,dineshsbm,1,0.00319,12951,41.31100,31350
1646,dipumonharidask,1,0.00319,12952,41.31419,31350
1647,diyfr,1,0.00319,12953,41.31738,31350
1648,djdevin,1,0.00319,12954,41.32057,31350
1649,DJMogens,1,0.00319,12955,41.32376,31350
1650,dk198150,1,0.00319,12956,41.32695,31350
1651,dlvoy,1,0.00319,12957,41.33014,31350
1652,dmeenhuis,1,0.00319,12958,41.33333,31350
1653,dmotte,1,0.00319,12959,41.33652,31350
1654,dmueller1607,1,0.00319,12960,41.33971,31350
1655,DmytroKozlovskyi,1,0.00319,12961,41.34290,31350
1656,Dominik-esb,1,0.00319,12962,41.34609,31350
1657,dominiklenhardt,1,0.00319,12963,41.34928,31350
1658,dorinclisu,1,0.00319,12964,41.35247,31350
1659,drdj85,1,0.00319,12965,41.35566,31350
1660,driv,1,0.00319,12966,41.35885,31350
1661,DrPsychick,1,0.00319,12967,41.36204,31350
1662,D-side,1,0.00319,12968,41.36523,31350
1663,ds-sebastian,1,0.00319,12969,41.36842,31350
1664,dsumac,1,0.00319,12970,41.37161,31350
1665,duemila2,1,0.00319,12971,41.37480,31350
1666,duponin,1,0.00319,12972,41.37799,31350
1667,dvv,1,0.00319,12973,41.38118,31350
1668,dwickern,1,0.00319,12974,41.38437,31350
1669,eamelink,1,0.00319,12975,41.38756,31350
1670,Eclixal,1,0.00319,12976,41.39075,31350
1671,edijsdrezovs,1,0.00319,12977,41.39394,31350
1672,EdwardCooke,1,0.00319,12978,41.39713,31350
1673,egezonberisha,1,0.00319,12979,41.40032,31350
1674,E-gy,1,0.00319,12980,41.40351,31350
1675,eightnoteight,1,0.00319,12981,41.40670,31350
1676,einyx,1,0.00319,12982,41.40989,31350
1677,eladbs,1,0.00319,12983,41.41308,31350
1678,elliliao,1,0.00319,12984,41.41627,31350
1679,elucyad,1,0.00319,12985,41.41946,31350
1680,emilyyujieli,1,0.00319,12986,41.42265,31350
1681,ENG3PLabs,1,0.00319,12987,41.42584,31350
1682,engineerXIII,1,0.00319,12988,41.42903,31350
1683,erwanGuiDecath,1,0.00319,12989,41.43222,31350
1684,EshemMimi,1,0.00319,12990,41.43541,31350
1685,etfeet,1,0.00319,12991,41.43860,31350
1686,Etienne-gh,1,0.00319,12992,41.44179,31350
1687,evanjrowley,1,0.00319,12993,41.44498,31350
1688,ezdac,1,0.00319,12994,41.44817,31350
1689,ezraw,1,0.00319,12995,41.45136,31350
1690,f0rdream,1,0.00319,12996,41.45455,31350
1691,fabbarix,1,0.00319,12997,41.45774,31350
1692,fabianboerner,1,0.00319,12998,41.46093,31350
1693,fabiankuenzer,1,0.00319,12999,41.46411,31350
1694,fabubacker,1,0.00319,13000,41.46730,31350
1695,facuparedes-litebox,1,0.00319,13001,41.47049,31350
1696,faresismail96,1,0.00319,13002,41.47368,31350
1697,farfalleflickan,1,0.00319,13003,41.47687,31350
1698,farhanramzan799,1,0.00319,13004,41.48006,31350
1699,farouqy,1,0.00319,13005,41.48325,31350
1700,FelipeEmerimRandon,1,0.00319,13006,41.48644,31350
1701,felixriehm,1,0.00319,13007,41.48963,31350
1702,Felk,1,0.00319,13008,41.49282,31350
1703,fengccp,1,0.00319,13009,41.49601,31350
1704,ferdinandmehlan,1,0.00319,13010,41.49920,31350
1705,FerdinandvHagen,1,0.00319,13011,41.50239,31350
1706,ferencszatmari,1,0.00319,13012,41.50558,31350
1707,ferhatys,1,0.00319,13013,41.50877,31350
1708,fgleixner,1,0.00319,13014,41.51196,31350
1709,fgsasha,1,0.00319,13015,41.51515,31350
1710,fidoriel,1,0.00319,13016,41.51834,31350
1711,FingerlessGlov3s,1,0.00319,13017,41.52153,31350
1712,fire833,1,0.00319,13018,41.52472,31350
1713,fizasayyed,1,0.00319,13019,41.52791,31350
1714,flowstate,1,0.00319,13020,41.53110,31350
1715,FlxPeters,1,0.00319,13021,41.53429,31350
1716,Fmstrat,1,0.00319,13022,41.53748,31350
1717,fnaeem78,1,0.00319,13023,41.54067,31350
1718,formatlos,1,0.00319,13024,41.54386,31350
1719,fpape,1,0.00319,13025,41.54705,31350
1720,framar89,1,0.00319,13026,41.55024,31350
1721,framillien,1,0.00319,13027,41.55343,31350
1722,frederiksf,1,0.00319,13028,41.55662,31350
1723,Freebios,1,0.00319,13029,41.55981,31350
1724,freick,1,0.00319,13030,41.56300,31350
1725,friedrich-at-adobe,1,0.00319,13031,41.56619,31350
1726,fr-orionfollett,1,0.00319,13032,41.56938,31350
1727,fschaefer,1,0.00319,13033,41.57257,31350
1728,fstaudt,1,0.00319,13034,41.57576,31350
1729,ftomassetti,1,0.00319,13035,41.57895,31350
1730,Furrior,1,0.00319,13036,41.58214,31350
1731,gabrielgbs97,1,0.00319,13037,41.58533,31350
1732,GabrielMajeri,1,0.00319,13038,41.58852,31350
1733,GabrielRivera21,1,0.00319,13039,41.59171,31350
1734,gaglimax,1,0.00319,13040,41.59490,31350
1735,galanteria01,1,0.00319,13041,41.59809,31350
1736,gamanyuk,1,0.00319,13042,41.60128,31350
1737,GarryLowther,1,0.00319,13043,41.60447,31350
1738,garryod,1,0.00319,13044,41.60766,31350
1739,gchappel,1,0.00319,13045,41.61085,31350
1740,gcleaves,1,0.00319,13046,41.61404,31350
1741,genert,1,0.00319,13047,41.61722,31350
1742,genio,1,0.00319,13048,41.62041,31350
1743,geoffreybauduin,1,0.00319,13049,41.62360,31350
1744,georgejdli,1,0.00319,13050,41.62679,31350
1745,gerardnico,1,0.00319,13051,41.62998,31350
1746,gfrankel97,1,0.00319,13052,41.63317,31350
1747,ggo-combination,1,0.00319,13053,41.63636,31350
1748,ghellings,1,0.00319,13054,41.63955,31350
1749,ghmer,1,0.00319,13055,41.64274,31350
1750,giang12,1,0.00319,13056,41.64593,31350
1751,gianlucapisati,1,0.00319,13057,41.64912,31350
1752,GilbertYoder,1,0.00319,13058,41.65231,31350
1753,githubbiswb,1,0.00319,13059,41.65550,31350
1754,gitPlatformTests,1,0.00319,13060,41.65869,31350
1755,gittobey,1,0.00319,13061,41.66188,31350
1756,gjelenc,1,0.00319,13062,41.66507,31350
1757,gkachru,1,0.00319,13063,41.66826,31350
1758,gkasturik,1,0.00319,13064,41.67145,31350
1759,gkdg,1,0.00319,13065,41.67464,31350
1760,gl1tch,1,0.00319,13066,41.67783,31350
1761,glb-cblin,1,0.00319,13067,41.68102,31350
1762,glory-ka,1,0.00319,13068,41.68421,31350
1763,gmbeneva,1,0.00319,13069,41.68740,31350
1764,GownerCode,1,0.00319,13070,41.69059,31350
1765,gowthamvadisetti,1,0.00319,13071,41.69378,31350
1766,gpcmol,1,0.00319,13072,41.69697,31350
1767,gps035,1,0.00319,13073,41.70016,31350
1768,gregrestivo,1,0.00319,13074,41.70335,31350
1769,grem11n,1,0.00319,13075,41.70654,31350
1770,grimurd,1,0.00319,13076,41.70973,31350
1771,gripenk,1,0.00319,13077,41.71292,31350
1772,gsnable,1,0.00319,13078,41.71611,31350
1773,guilhermedalmarco,1,0.00319,13079,41.71930,31350
1774,guillaumesmo,1,0.00319,13080,41.72249,31350
1775,Guite,1,0.00319,13081,41.72568,31350
1776,guyspr,1,0.00319,13082,41.72887,31350
1777,gyanprakash48,1,0.00319,13083,41.73206,31350
1778,gyurco,1,0.00319,13084,41.73525,31350
1779,hacst,1,0.00319,13085,41.73844,31350
1780,haeraeus,1,0.00319,13086,41.74163,31350
1781,hagaram,1,0.00319,13087,41.74482,31350
1782,hahasheminejad,1,0.00319,13088,41.74801,31350
1783,hamburgerbun,1,0.00319,13089,41.75120,31350
1784,hanaws-1,1,0.00319,13090,41.75439,31350
1785,hanleirx,1,0.00319,13091,41.75758,31350
1786,hanswieheiri,1,0.00319,13092,41.76077,31350
1787,harindaka,1,0.00319,13093,41.76396,31350
1788,harinlee0803,1,0.00319,13094,41.76715,31350
1789,harlemmuniz,1,0.00319,13095,41.77033,31350
1790,harveyjing,1,0.00319,13096,41.77352,31350
1791,HashiBeliver,1,0.00319,13097,41.77671,31350
1792,hassan11196,1,0.00319,13098,41.77990,31350
1793,HassanMSh,1,0.00319,13099,41.78309,31350
1794,haugompit,1,0.00319,13100,41.78628,31350
1795,hauserkristof,1,0.00319,13101,41.78947,31350
1796,henricbjork2liu,1,0.00319,13102,41.79266,31350
1797,hereCOMESlappy,1,0.00319,13103,41.79585,31350
1798,hesstobi,1,0.00319,13104,41.79904,31350
1799,hexagonhill,1,0.00319,13105,41.80223,31350
1800,heyrun,1,0.00319,13106,41.80542,31350
1801,hmd-ai,1,0.00319,13107,41.80861,31350
1802,hmrc87,1,0.00319,13108,41.81180,31350
1803,hoantran3108,1,0.00319,13109,41.81499,31350
1804,HoKim98,1,0.00319,13110,41.81818,31350
1805,Horgul123,1,0.00319,13111,41.82137,31350
1806,horw,1,0.00319,13112,41.82456,31350
1807,HotThoughts,1,0.00319,13113,41.82775,31350
1808,HoussemEs,1,0.00319,13114,41.83094,31350
1809,hstridh,1,0.00319,13115,41.83413,31350
1810,huangzhaor,1,0.00319,13116,41.83732,31350
1811,huaphuoctruong,1,0.00319,13117,41.84051,31350
1812,huynguyen-b3networks,1,0.00319,13118,41.84370,31350
1813,hvoss,1,0.00319,13119,41.84689,31350
1814,i5Js,1,0.00319,13120,41.85008,31350
1815,ibuys,1,0.00319,13121,41.85327,31350
1816,iCreateJB,1,0.00319,13122,41.85646,31350
1817,Idan-Lazar,1,0.00319,13123,41.85965,31350
1818,iddelacruz,1,0.00319,13124,41.86284,31350
1819,idefixcert,1,0.00319,13125,41.86603,31350
1820,ifrido,1,0.00319,13126,41.86922,31350
1821,iFrozenPhoenix,1,0.00319,13127,41.87241,31350
1822,igloo15,1,0.00319,13128,41.87560,31350
1823,igops,1,0.00319,13129,41.87879,31350
1824,IgorGolivets,1,0.00319,13130,41.88198,31350
1825,iinuwa,1,0.00319,13131,41.88517,31350
1826,ikatzarski,1,0.00319,13132,41.88836,31350
1827,ilangersht1,1,0.00319,13133,41.89155,31350
1828,iliketoprogram14,1,0.00319,13134,41.89474,31350
1829,ilyesAj,1,0.00319,13135,41.89793,31350
1830,imarkvisser,1,0.00319,13136,41.90112,31350
1831,imiller445,1,0.00319,13137,41.90431,31350
1832,ImpThomasHein,1,0.00319,13138,41.90750,31350
1833,IngwiePhoenix,1,0.00319,13139,41.91069,31350
1834,inmotiv,1,0.00319,13140,41.91388,31350
1835,InspektorWarnebring,1,0.00319,13141,41.91707,31350
1836,integsoft-company,1,0.00319,13142,41.92026,31350
1837,ishaqkhattana,1,0.00319,13143,41.92344,31350
1838,islam56naser,1,0.00319,13144,41.92663,31350
1839,iso70x,1,0.00319,13145,41.92982,31350
1840,isouzasoares,1,0.00319,13146,41.93301,31350
1841,itmwiw,1,0.00319,13147,41.93620,31350
1842,It-Prooffice,1,0.00319,13148,41.93939,31350
1843,ItsZiroy,1,0.00319,13149,41.94258,31350
1844,IvayLoRD,1,0.00319,13150,41.94577,31350
1845,iveshenry18,1,0.00319,13151,41.94896,31350
1846,IZ6HSR,1,0.00319,13152,41.95215,31350
1847,jacen05,1,0.00319,13153,41.95534,31350
1848,jacky96623,1,0.00319,13154,41.95853,31350
1849,jali-clarke,1,0.00319,13155,41.96172,31350
1850,jamesregis,1,0.00319,13156,41.96491,31350
1851,janaki-sasidhar,1,0.00319,13157,41.96810,31350
1852,Jan-M,1,0.00319,13158,41.97129,31350
1853,jaredvacanti,1,0.00319,13159,41.97448,31350
1854,jarosenthal,1,0.00319,13160,41.97767,31350
1855,JavaPythonAIForBAT,1,0.00319,13161,41.98086,31350
1856,jayd3e,1,0.00319,13162,41.98405,31350
1857,jboesh,1,0.00319,13163,41.98724,31350
1858,jceresini,1,0.00319,13164,41.99043,31350
1859,jdthorpe,1,0.00319,13165,41.99362,31350
1860,jecnua,1,0.00319,13166,41.99681,31350
1861,jeffwmiles,1,0.00319,13167,42.00000,31350
1862,Jeinhaus,1,0.00319,13168,42.00319,31350
1863,jenqaz,1,0.00319,13169,42.00638,31350
1864,jenswachtel,1,0.00319,13170,42.00957,31350
1865,jeremiaspt,1,0.00319,13171,42.01276,31350
1866,jeremyvanhove,1,0.00319,13172,42.01595,31350
1867,jerryhopper,1,0.00319,13173,42.01914,31350
1868,jesinity,1,0.00319,13174,42.02233,31350
1869,jesusprubio,1,0.00319,13175,42.02552,31350
1870,JethroMV,1,0.00319,13176,42.02871,31350
1871,jholt96,1,0.00319,13177,42.03190,31350
1872,jhorman8,1,0.00319,13178,42.03509,31350
1873,jimvandervoort,1,0.00319,13179,42.03828,31350
1874,JinruiDuan,1,0.00319,13180,42.04147,31350
1875,jinsoo-youn,1,0.00319,13181,42.04466,31350
1876,jjmanton,1,0.00319,13182,42.04785,31350
1877,jlarwig,1,0.00319,13183,42.05104,31350
1878,jmholzer,1,0.00319,13184,42.05423,31350
1879,jobinjosem1,1,0.00319,13185,42.05742,31350
1880,JoelBirlingmairBeastCode,1,0.00319,13186,42.06061,31350
1881,joelsdc,1,0.00319,13187,42.06380,31350
1882,joeybdub,1,0.00319,13188,42.06699,31350
1883,Jogai,1,0.00319,13189,42.07018,31350
1884,johanhammar,1,0.00319,13190,42.07337,31350
1885,Johannestegner,1,0.00319,13191,42.07656,31350
1886,JohnMaguire,1,0.00319,13192,42.07974,31350
1887,JohnMav,1,0.00319,13193,42.08293,31350
1888,johnny990,1,0.00319,13194,42.08612,31350
1889,johnrommelcarrascal,1,0.00319,13195,42.08931,31350
1890,JoJ123,1,0.00319,13196,42.09250,31350
1891,Joker9944,1,0.00319,13197,42.09569,31350
1892,Jokertwo,1,0.00319,13198,42.09888,31350
1893,Joko-cgi,1,0.00319,13199,42.10207,31350
1894,joliebig,1,0.00319,13200,42.10526,31350
1895,jonananas,1,0.00319,13201,42.10845,31350
1896,jonas-weismueller-by,1,0.00319,13202,42.11164,31350
1897,joraff,1,0.00319,13203,42.11483,31350
1898,jordangarside-kiwi,1,0.00319,13204,42.11802,31350
1899,josemolinai-bcs,1,0.00319,13205,42.12121,31350
1900,jp,1,0.00319,13206,42.12440,31350
1901,jsargiot,1,0.00319,13207,42.12759,31350
1902,jsmouret,1,0.00319,13208,42.13078,31350
1903,jub77,1,0.00319,13209,42.13397,31350
1904,Juganooo,1,0.00319,13210,42.13716,31350
1905,julian-barske,1,0.00319,13211,42.14035,31350
1906,julienlau,1,0.00319,13212,42.14354,31350
1907,JuroOravec,1,0.00319,13213,42.14673,31350
1908,justarandomsysadmin,1,0.00319,13214,42.14992,31350
1909,justin2ndwatch,1,0.00319,13215,42.15311,31350
1910,jwaffe75,1,0.00319,13216,42.15630,31350
1911,jwatson0,1,0.00319,13217,42.15949,31350
1912,k0uki,1,0.00319,13218,42.16268,31350
1913,Kabsuri31,1,0.00319,13219,42.16587,31350
1914,kacifer,1,0.00319,13220,42.16906,31350
1915,kaja-mohideen,1,0.00319,13221,42.17225,31350
1916,kalw,1,0.00319,13222,42.17544,31350
1917,karnain1803,1,0.00319,13223,42.17863,31350
1918,KarstenWintermann,1,0.00319,13224,42.18182,31350
1919,kasbst,1,0.00319,13225,42.18501,31350
1920,kaufmo,1,0.00319,13226,42.18820,31350
1921,kazaroff,1,0.00319,13227,42.19139,31350
1922,kazuki43zoo,1,0.00319,13228,42.19458,31350
1923,kennylam777,1,0.00319,13229,42.19777,31350
1924,kennylam91,1,0.00319,13230,42.20096,31350
1925,k-e-r-n-e-l-p-a-n-i-c,1,0.00319,13231,42.20415,31350
1926,kerryeon,1,0.00319,13232,42.20734,31350
1927,keyhana,1,0.00319,13233,42.21053,31350
1928,khartahk,1,0.00319,13234,42.21372,31350
1929,ki28,1,0.00319,13235,42.21691,31350
1930,kimbo,1,0.00319,13236,42.22010,31350
1931,Kipre,1,0.00319,13237,42.22329,31350
1932,kishorv06,1,0.00319,13238,42.22648,31350
1933,k-k-k-k-k-k-k-k,1,0.00319,13239,42.22967,31350
1934,kladiv,1,0.00319,13240,42.23285,31350
1935,knacktim,1,0.00319,13241,42.23604,31350
1936,knordum,1,0.00319,13242,42.23923,31350
1937,koendelaat,1,0.00319,13243,42.24242,31350
1938,KolbPh,1,0.00319,13244,42.24561,31350
1939,komainu-ctrl,1,0.00319,13245,42.24880,31350
1940,kosov73,1,0.00319,13246,42.25199,31350
1941,kregerre,1,0.00319,13247,42.25518,31350
1942,krenaut62,1,0.00319,13248,42.25837,31350
1943,krishnakc1,1,0.00319,13249,42.26156,31350
1944,kromanow94,1,0.00319,13250,42.26475,31350
1945,krupakar1329,1,0.00319,13251,42.26794,31350
1946,kryz-flwls,1,0.00319,13252,42.27113,31350
1947,k-sareen,1,0.00319,13253,42.27432,31350
1948,Kshitij-Katiyar,1,0.00319,13254,42.27751,31350
1949,Kummerkasten,1,0.00319,13255,42.28070,31350
1950,kupmanyu,1,0.00319,13256,42.28389,31350
1951,kyfrankie,1,0.00319,13257,42.28708,31350
1952,kym6464,1,0.00319,13258,42.29027,31350
1953,l7devops,1,0.00319,13259,42.29346,31350
1954,laduke,1,0.00319,13260,42.29665,31350
1955,LanceXuanLi,1,0.00319,13261,42.29984,31350
1956,laszlocph,1,0.00319,13262,42.30303,31350
1957,laurentthiebaudezm,1,0.00319,13263,42.30622,31350
1958,lbvffvbl,1,0.00319,13264,42.30941,31350
1959,ldynia,1,0.00319,13265,42.31260,31350
1960,lefeverd,1,0.00319,13266,42.31579,31350
1961,leonardbiofi,1,0.00319,13267,42.31898,31350
1962,leopku,1,0.00319,13268,42.32217,31350
1963,letsbringachange,1,0.00319,13269,42.32536,31350
1964,lgastler,1,0.00319,13270,42.32855,31350
1965,libussa,1,0.00319,13271,42.33174,31350
1966,linolayani,1,0.00319,13272,42.33493,31350
1967,lino-layani-ssq,1,0.00319,13273,42.33812,31350
1968,liormaran,1,0.00319,13274,42.34131,31350
1969,liudadaxxx,1,0.00319,13275,42.34450,31350
1970,liviozanol,1,0.00319,13276,42.34769,31350
1971,livius100,1,0.00319,13277,42.35088,31350
1972,lmebonia,1,0.00319,13278,42.35407,31350
1973,loispostula,1,0.00319,13279,42.35726,31350
1974,LongLiveCHIEF,1,0.00319,13280,42.36045,31350
1975,lotooo,1,0.00319,13281,42.36364,31350
1976,lswartsenburg,1,0.00319,13282,42.36683,31350
1977,ltickett,1,0.00319,13283,42.37002,31350
1978,LuckyChen666,1,0.00319,13284,42.37321,31350
1979,luizribeiro,1,0.00319,13285,42.37640,31350
1980,lukeyeager,1,0.00319,13286,42.37959,31350
1981,luklichtm,1,0.00319,13287,42.38278,31350
1982,lusoalex,1,0.00319,13288,42.38596,31350
1983,lvijnck,1,0.00319,13289,42.38915,31350
1984,macakmujo,1,0.00319,13290,42.39234,31350
1985,Macrisu,1,0.00319,13291,42.39553,31350
1986,mahaupt,1,0.00319,13292,42.39872,31350
1987,MakerT,1,0.00319,13293,42.40191,31350
1988,ManInFez,1,0.00319,13294,42.40510,31350
1989,manipulator01,1,0.00319,13295,42.40829,31350
1990,marcellmars,1,0.00319,13296,42.41148,31350
1991,marco27183,1,0.00319,13297,42.41467,31350
1992,marcomusso,1,0.00319,13298,42.41786,31350
1993,marcsello,1,0.00319,13299,42.42105,31350
1994,marcusvezz,1,0.00319,13300,42.42424,31350
1995,Mariappan,1,0.00319,13301,42.42743,31350
1996,marinkobabic,1,0.00319,13302,42.43062,31350
1997,mark19142218,1,0.00319,13303,42.43381,31350
1998,markuzzi,1,0.00319,13304,42.43700,31350
1999,marshall-orevillestudios,1,0.00319,13305,42.44019,31350
2000,martinbalint,1,0.00319,13306,42.44338,31350
2001,martinlindner,1,0.00319,13307,42.44657,31350
2002,MartinRied,1,0.00319,13308,42.44976,31350
2003,MarymAmirshah,1,0.00319,13309,42.45295,31350
2004,masalinas,1,0.00319,13310,42.45614,31350
2005,mashedkeyboard,1,0.00319,13311,42.45933,31350
2006,matheusMoreno,1,0.00319,13312,42.46252,31350
2007,matmah,1,0.00319,13313,42.46571,31350
2008,mattfield,1,0.00319,13314,42.46890,31350
2009,Matthiator,1,0.00319,13315,42.47209,31350
2010,mattintech,1,0.00319,13316,42.47528,31350
2011,matyuda,1,0.00319,13317,42.47847,31350
2012,mawuliadjoda,1,0.00319,13318,42.48166,31350
2013,maxlerebourg,1,0.00319,13319,42.48485,31350
2014,maxomizer,1,0.00319,13320,42.48804,31350
2015,mayank14798,1,0.00319,13321,42.49123,31350
2016,mayday77-77,1,0.00319,13322,42.49442,31350
2017,mayur-kumar1,1,0.00319,13323,42.49761,31350
2018,mbastress,1,0.00319,13324,42.50080,31350
2019,mbelak-dtml,1,0.00319,13325,42.50399,31350
2020,mblaschke-daimlertruck,1,0.00319,13326,42.50718,31350
2021,mbunkus,1,0.00319,13327,42.51037,31350
2022,mcfdez,1,0.00319,13328,42.51356,31350
2023,mcrapts,1,0.00319,13329,42.51675,31350
2024,mcs,1,0.00319,13330,42.51994,31350
2025,mdoro-13,1,0.00319,13331,42.52313,31350
2026,Mearman,1,0.00319,13332,42.52632,31350
2027,MedoDome,1,0.00319,13333,42.52951,31350
2028,meesvandongen,1,0.00319,13334,42.53270,31350
2029,mehdi-benhajabbes,1,0.00319,13335,42.53589,31350
2030,mehdi-eaton,1,0.00319,13336,42.53907,31350
2031,memdealer,1,0.00319,13337,42.54226,31350
2032,mengyaoyang11,1,0.00319,13338,42.54545,31350
2033,merlyel,1,0.00319,13339,42.54864,31350
2034,metopatel,1,0.00319,13340,42.55183,31350
2035,mfettig,1,0.00319,13341,42.55502,31350
2036,mfinkoleukeleu,1,0.00319,13342,42.55821,31350
2037,mgstoyanov,1,0.00319,13343,42.56140,31350
2038,mhoegger,1,0.00319,13344,42.56459,31350
2039,miaw7,1,0.00319,13345,42.56778,31350
2040,michaelbilow,1,0.00319,13346,42.57097,31350
2041,michaelmccord,1,0.00319,13347,42.57416,31350
2042,michael-schmidt-mck,1,0.00319,13348,42.57735,31350
2043,MichalisDBA,1,0.00319,13349,42.58054,31350
2044,michelpromonet,1,0.00319,13350,42.58373,31350
2045,michel-zimmer,1,0.00319,13351,42.58692,31350
2046,miguelebf,1,0.00319,13352,42.59011,31350
2047,miiihi,1,0.00319,13353,42.59330,31350
2048,mikekuzak,1,0.00319,13354,42.59649,31350
2049,MikeShiner,1,0.00319,13355,42.59968,31350
2050,mikeymop,1,0.00319,13356,42.60287,31350
2051,milijander88,1,0.00319,13357,42.60606,31350
2052,milkfinch,1,0.00319,13358,42.60925,31350
2053,mind-overflow,1,0.00319,13359,42.61244,31350
2054,MironovOleg,1,0.00319,13360,42.61563,31350
2055,mishael-o,1,0.00319,13361,42.61882,31350
2056,Mistuke,1,0.00319,13362,42.62201,31350
2057,mjgarton,1,0.00319,13363,42.62520,31350
2058,mjgp2,1,0.00319,13364,42.62839,31350
2059,mjmonroe,1,0.00319,13365,42.63158,31350
2060,mjpieters,1,0.00319,13366,42.63477,31350
2061,m-koehler,1,0.00319,13367,42.63796,31350
2062,moessnero,1,0.00319,13368,42.64115,31350
2063,Moglum,1,0.00319,13369,42.64434,31350
2064,Mohitp98,1,0.00319,13370,42.64753,31350
2065,moritz31,1,0.00319,13371,42.65072,31350
2066,moss2k13,1,0.00319,13372,42.65391,31350
2067,mpratsch,1,0.00319,13373,42.65710,31350
2068,MrBanana05,1,0.00319,13374,42.66029,31350
2069,mrlhansen,1,0.00319,13375,42.66348,31350
2070,mrnovalles,1,0.00319,13376,42.66667,31350
2071,msvechla,1,0.00319,13377,42.66986,31350
2072,mteodor,1,0.00319,13378,42.67305,31350
2073,mtmSchoenberger,1,0.00319,13379,42.67624,31350
2074,mtneug,1,0.00319,13380,42.67943,31350
2075,mtnstar,1,0.00319,13381,42.68262,31350
2076,muir,1,0.00319,13382,42.68581,31350
2077,munkyjunky,1,0.00319,13383,42.68900,31350
2078,mwinham81,1,0.00319,13384,42.69219,31350
2079,mwllgr,1,0.00319,13385,42.69537,31350
2080,MXClyde,1,0.00319,13386,42.69856,31350
2081,myers,1,0.00319,13387,42.70175,31350
2082,MylchenkoAlexandr,1,0.00319,13388,42.70494,31350
2083,mzndr,1,0.00319,13389,42.70813,31350
2084,n3xem,1,0.00319,13390,42.71132,31350
2085,nangoku-penguin,1,0.00319,13391,42.71451,31350
2086,nate-watkins,1,0.00319,13392,42.71770,31350
2087,naveenduddi,1,0.00319,13393,42.72089,31350
2088,nawatts,1,0.00319,13394,42.72408,31350
2089,nblock,1,0.00319,13395,42.72727,31350
2090,nbonavia,1,0.00319,13396,42.73046,31350
2091,ndevireddy,1,0.00319,13397,42.73365,31350
2092,ndtreviv,1,0.00319,13398,42.73684,31350
2093,NegativeFeedback,1,0.00319,13399,42.74003,31350
2094,neiser,1,0.00319,13400,42.74322,31350
2095,NeoTechni,1,0.00319,13401,42.74641,31350
2096,nepeat,1,0.00319,13402,42.74960,31350
2097,netchild,1,0.00319,13403,42.75279,31350
2098,NeurekaSoftware,1,0.00319,13404,42.75598,31350
2099,NeutronSelector,1,0.00319,13405,42.75917,31350
2100,nguyen-trantrung,1,0.00319,13406,42.76236,31350
2101,Nicba1010,1,0.00319,13407,42.76555,31350
2102,nickchung,1,0.00319,13408,42.76874,31350
2103,NickSegalle,1,0.00319,13409,42.77193,31350
2104,nickwilliams-codynamic,1,0.00319,13410,42.77512,31350
2105,nicolo-danzi,1,0.00319,13411,42.77831,31350
2106,nidhin077,1,0.00319,13412,42.78150,31350
2107,nightcoding,1,0.00319,13413,42.78469,31350
2108,nik123,1,0.00319,13414,42.78788,31350
2109,niklasweimann,1,0.00319,13415,42.79107,31350
2110,nikolayrk,1,0.00319,13416,42.79426,31350
2111,NilsEngelbach,1,0.00319,13417,42.79745,31350
2112,nishant884,1,0.00319,13418,42.80064,31350
2113,nishit93-hub,1,0.00319,13419,42.80383,31350
2114,nmass-betpawa,1,0.00319,13420,42.80702,31350
2115,nnelson1601,1,0.00319,13421,42.81021,31350
2116,nodje,1,0.00319,13422,42.81340,31350
2117,nolyoi,1,0.00319,13423,42.81659,31350
2118,Not-freql,1,0.00319,13424,42.81978,31350
2119,npapapietro,1,0.00319,13425,42.82297,31350
2120,oauth222,1,0.00319,13426,42.82616,31350
2121,obikay200,1,0.00319,13427,42.82935,31350
2122,odin-delrio,1,0.00319,13428,42.83254,31350
2123,ofer-w,1,0.00319,13429,42.83573,31350
2124,ogbonnaec,1,0.00319,13430,42.83892,31350
2125,olopost,1,0.00319,13431,42.84211,31350
2126,oshmyrko,1,0.00319,13432,42.84530,31350
2127,ossentoo,1,0.00319,13433,42.84848,31350
2128,p1r4t3-s4il0r,1,0.00319,13434,42.85167,31350
2129,pa5446530a,1,0.00319,13435,42.85486,31350
2130,PabloPie,1,0.00319,13436,42.85805,31350
2131,paddy-hack,1,0.00319,13437,42.86124,31350
2132,PaddyKe,1,0.00319,13438,42.86443,31350
2133,Pastello,1,0.00319,13439,42.86762,31350
2134,patrickneubauer,1,0.00319,13440,42.87081,31350
2135,patrickpaul-crew,1,0.00319,13441,42.87400,31350
2136,paulblum00,1,0.00319,13442,42.87719,31350
2137,paulwouters,1,0.00319,13443,42.88038,31350
2138,pavanparthasarathy,1,0.00319,13444,42.88357,31350
2139,pavianogiacomo,1,0.00319,13445,42.88676,31350
2140,pavlm,1,0.00319,13446,42.88995,31350
2141,pbdco,1,0.00319,13447,42.89314,31350
2142,pbwur,1,0.00319,13448,42.89633,31350
2143,peadarDoyle,1,0.00319,13449,42.89952,31350
2144,peckloris,1,0.00319,13450,42.90271,31350
2145,pedreen,1,0.00319,13451,42.90590,31350
2146,pedrohjordao,1,0.00319,13452,42.90909,31350
2147,peter-miroshnikov,1,0.00319,13453,42.91228,31350
2148,peyerroger,1,0.00319,13454,42.91547,31350
2149,pf-rvvup,1,0.00319,13455,42.91866,31350
2150,pgassmann,1,0.00319,13456,42.92185,31350
2151,phidlipus,1,0.00319,13457,42.92504,31350
2152,phmcder,1,0.00319,13458,42.92823,31350
2153,pi3ch,1,0.00319,13459,42.93142,31350
2154,pinarruiz,1,0.00319,13460,42.93461,31350
2155,piscue,1,0.00319,13461,42.93780,31350
2156,pitkes22,1,0.00319,13462,42.94099,31350
2157,pixelblender,1,0.00319,13463,42.94418,31350
2158,pjeby,1,0.00319,13464,42.94737,31350
2159,pkoenig10,1,0.00319,13465,42.95056,31350
2160,pmargom,1,0.00319,13466,42.95375,31350
2161,pmeier,1,0.00319,13467,42.95694,31350
2162,pnoguera,1,0.00319,13468,42.96013,31350
2163,pommelinho,1,0.00319,13469,42.96332,31350
2164,Pooyahmti,1,0.00319,13470,42.96651,31350
2165,porobd,1,0.00319,13471,42.96970,31350
2166,PoudNL,1,0.00319,13472,42.97289,31350
2167,ppizq,1,0.00319,13473,42.97608,31350
2168,pravargauba,1,0.00319,13474,42.97927,31350
2169,predakanga,1,0.00319,13475,42.98246,31350
2170,protyposis,1,0.00319,13476,42.98565,31350
2171,prudnitskiy,1,0.00319,13477,42.98884,31350
2172,Pshemas,1,0.00319,13478,42.99203,31350
2173,ptescher,1,0.00319,13479,42.99522,31350
2174,pulkit0627,1,0.00319,13480,42.99841,31350
2175,purejgleason,1,0.00319,13481,43.00159,31350
2176,pushc6,1,0.00319,13482,43.00478,31350
2177,PyrkovKonstantin,1,0.00319,13483,43.00797,31350
2178,qtan-carbon,1,0.00319,13484,43.01116,31350
2179,quantumdecoherence,1,0.00319,13485,43.01435,31350
2180,r9labs,1,0.00319,13486,43.01754,31350
2181,radumoisan,1,0.00319,13487,43.02073,31350
2182,RafaMunoz,1,0.00319,13488,43.02392,31350
2183,rafsaf,1,0.00319,13489,43.02711,31350
2184,rahgadda,1,0.00319,13490,43.03030,31350
2185,Rakhmanov,1,0.00319,13491,43.03349,31350
2186,ramonmedeiros,1,0.00319,13492,43.03668,31350
2187,raphschm,1,0.00319,13493,43.03987,31350
2188,ravenolf,1,0.00319,13494,43.04306,31350
2189,raz08,1,0.00319,13495,43.04625,31350
2190,rborer,1,0.00319,13496,43.04944,31350
2191,rburgst,1,0.00319,13497,43.05263,31350
2192,rcampbell-LI,1,0.00319,13498,43.05582,31350
2193,rdeaton,1,0.00319,13499,43.05901,31350
2194,rd-michel,1,0.00319,13500,43.06220,31350
2195,reespozzi,1,0.00319,13501,43.06539,31350
2196,regmicmahesh,1,0.00319,13502,43.06858,31350
2197,RegturH,1,0.00319,13503,43.07177,31350
2198,ReignbowRoad,1,0.00319,13504,43.07496,31350
2199,ReinoudBok,1,0.00319,13505,43.07815,31350
2200,rhuanbarreto,1,0.00319,13506,43.08134,31350
2201,RichardTheHouse,1,0.00319,13507,43.08453,31350
2202,ridhoq,1,0.00319,13508,43.08772,31350
2203,RileyNorton,1,0.00319,13509,43.09091,31350
2204,r-ising,1,0.00319,13510,43.09410,31350
2205,rkachach,1,0.00319,13511,43.09729,31350
2206,rkeshmir,1,0.00319,13512,43.10048,31350
2207,rlabinot,1,0.00319,13513,43.10367,31350
2208,rlex,1,0.00319,13514,43.10686,31350
2209,rliao73github,1,0.00319,13515,43.11005,31350
2210,rmkanda,1,0.00319,13516,43.11324,31350
2211,R-N,1,0.00319,13517,43.11643,31350
2212,robertsmaoui,1,0.00319,13518,43.11962,31350
2213,robinlandstrom,1,0.00319,13519,43.12281,31350
2214,robin-peter-ripcord,1,0.00319,13520,43.12600,31350
2215,robo-cap,1,0.00319,13521,43.12919,31350
2216,RodrigoTHD,1,0.00319,13522,43.13238,31350
2217,roshanlasantha,1,0.00319,13523,43.13557,31350
2218,roth-wine,1,0.00319,13524,43.13876,31350
2219,rpeets,1,0.00319,13525,43.14195,31350
2220,rperpe,1,0.00319,13526,43.14514,31350
2221,rsrdesarrollo,1,0.00319,13527,43.14833,31350
2222,rstoermer,1,0.00319,13528,43.15152,31350
2223,rstrazza,1,0.00319,13529,43.15470,31350
2224,rubasace,1,0.00319,13530,43.15789,31350
2225,rubikcube7,1,0.00319,13531,43.16108,31350
2226,rukayaj,1,0.00319,13532,43.16427,31350
2227,rwblokzijl,1,0.00319,13533,43.16746,31350
2228,ryosk7,1,0.00319,13534,43.17065,31350
2229,saashqdev,1,0.00319,13535,43.17384,31350
2230,sahmadinejad-varmour,1,0.00319,13536,43.17703,31350
2231,saifhilichi22,1,0.00319,13537,43.18022,31350
2232,samhine,1,0.00319,13538,43.18341,31350
2233,SamSpiri,1,0.00319,13539,43.18660,31350
2234,samuelfischerscandio,1,0.00319,13540,43.18979,31350
2235,sancho21,1,0.00319,13541,43.19298,31350
2236,Sanqui,1,0.00319,13542,43.19617,31350
2237,SantiagoGaonaC,1,0.00319,13543,43.19936,31350
2238,santoshbr4,1,0.00319,13544,43.20255,31350
2239,saqlain24,1,0.00319,13545,43.20574,31350
2240,sarming,1,0.00319,13546,43.20893,31350
2241,sathishstar25,1,0.00319,13547,43.21212,31350
2242,savitha-qs,1,0.00319,13548,43.21531,31350
2243,sbharadwaj1,1,0.00319,13549,43.21850,31350
2244,scheffold,1,0.00319,13550,43.22169,31350
2245,scherrer,1,0.00319,13551,43.22488,31350
2246,schoeppi5,1,0.00319,13552,43.22807,31350
2247,sclinnell,1,0.00319,13553,43.23126,31350
2248,scottnuma,1,0.00319,13554,43.23445,31350
2249,SebastianBakala-TomTom,1,0.00319,13555,43.23764,31350
2250,sedan07,1,0.00319,13556,43.24083,31350
2251,SegFaultAX,1,0.00319,13557,43.24402,31350
2252,seilerre,1,0.00319,13558,43.24721,31350
2253,Semihal,1,0.00319,13559,43.25040,31350
2254,senpro-ingwersenk,1,0.00319,13560,43.25359,31350
2255,seos-vcbs,1,0.00319,13561,43.25678,31350
2256,Sergiodfdez,1,0.00319,13562,43.25997,31350
2257,sethlinnkuleuven,1,0.00319,13563,43.26316,31350
2258,sfl-andrej,1,0.00319,13564,43.26635,31350
2259,sgillies-tpzuk,1,0.00319,13565,43.26954,31350
2260,sgrimm,1,0.00319,13566,43.27273,31350
2261,sh0yu,1,0.00319,13567,43.27592,31350
2262,Shaktizala,1,0.00319,13568,43.27911,31350
2263,shalin-hudda,1,0.00319,13569,43.28230,31350
2264,ShaneCray,1,0.00319,13570,43.28549,31350
2265,sharif9876,1,0.00319,13571,43.28868,31350
2266,shashrath,1,0.00319,13572,43.29187,31350
2267,shauder,1,0.00319,13573,43.29506,31350
2268,shbatm,1,0.00319,13574,43.29825,31350
2269,shellsniper,1,0.00319,13575,43.30144,31350
2270,shepwalker,1,0.00319,13576,43.30463,31350
2271,Shipuli,1,0.00319,13577,43.30781,31350
2272,shmolyneaux,1,0.00319,13578,43.31100,31350
2273,shotor,1,0.00319,13579,43.31419,31350
2274,shouptech,1,0.00319,13580,43.31738,31350
2275,simplyzee,1,0.00319,13581,43.32057,31350
2276,SirSkizo,1,0.00319,13582,43.32376,31350
2277,Sissi44,1,0.00319,13583,43.32695,31350
2278,skarampatakis,1,0.00319,13584,43.33014,31350
2279,sled,1,0.00319,13585,43.33333,31350
2280,sleepydomino,1,0.00319,13586,43.33652,31350
2281,sleidig,1,0.00319,13587,43.33971,31350
2282,SLoeuillet,1,0.00319,13588,43.34290,31350
2283,SlytherinCz,1,0.00319,13589,43.34609,31350
2284,smazurov,1,0.00319,13590,43.34928,31350
2285,smehboub-dkt,1,0.00319,13591,43.35247,31350
2286,smokeythebandit,1,0.00319,13592,43.35566,31350
2287,smulikHakipod,1,0.00319,13593,43.35885,31350
2288,snrraptopack,1,0.00319,13594,43.36204,31350
2289,sofian-ysf,1,0.00319,13595,43.36523,31350
2290,softyn,1,0.00319,13596,43.36842,31350
2291,sokbunthean,1,0.00319,13597,43.37161,31350
2292,SolidSnail727,1,0.00319,13598,43.37480,31350
2293,someburner,1,0.00319,13599,43.37799,31350
2294,spahrson,1,0.00319,13600,43.38118,31350
2295,spetar,1,0.00319,13601,43.38437,31350
2296,spireob,1,0.00319,13602,43.38756,31350
2297,srs,1,0.00319,13603,43.39075,31350
2298,s-rwe,1,0.00319,13604,43.39394,31350
2299,ssitsp,1,0.00319,13605,43.39713,31350
2300,ssunilk,1,0.00319,13606,43.40032,31350
2301,stanislav-c,1,0.00319,13607,43.40351,31350
2302,staplWaldo,1,0.00319,13608,43.40670,31350
2303,StarGrim33,1,0.00319,13609,43.40989,31350
2304,StefanMarkmann,1,0.00319,13610,43.41308,31350
2305,stevenayers,1,0.00319,13611,43.41627,31350
2306,stevenruizhang,1,0.00319,13612,43.41946,31350
2307,stfnzl,1,0.00319,13613,43.42265,31350
2308,stoffus,1,0.00319,13614,43.42584,31350
2309,stovla,1,0.00319,13615,43.42903,31350
2310,StrongSteve,1,0.00319,13616,43.43222,31350
2311,sudoduan,1,0.00319,13617,43.43541,31350
2312,sumeetgodse,1,0.00319,13618,43.43860,31350
2313,sunsided,1,0.00319,13619,43.44179,31350
2314,suxatcode,1,0.00319,13620,43.44498,31350
2315,Svarto,1,0.00319,13621,43.44817,31350
2316,svithalani-washpost,1,0.00319,13622,43.45136,31350
2317,swarupdonepudi,1,0.00319,13623,43.45455,31350
2318,swbsf,1,0.00319,13624,43.45774,31350
2319,swinkelp1,1,0.00319,13625,43.46093,31350
2320,Sykar77,1,0.00319,13626,43.46411,31350
2321,syrphide,1,0.00319,13627,43.46730,31350
2322,szediktam,1,0.00319,13628,43.47049,31350
2323,t7tran,1,0.00319,13629,43.47368,31350
2324,tal763,1,0.00319,13630,43.47687,31350
2325,taladar,1,0.00319,13631,43.48006,31350
2326,tamerlan-musayev,1,0.00319,13632,43.48325,31350
2327,Tantino,1,0.00319,13633,43.48644,31350
2328,targs08,1,0.00319,13634,43.48963,31350
2329,taru-j-a-i-n,1,0.00319,13635,43.49282,31350
2330,tatellos,1,0.00319,13636,43.49601,31350
2331,tatroc,1,0.00319,13637,43.49920,31350
2332,Tawmu,1,0.00319,13638,43.50239,31350
2333,taz77,1,0.00319,13639,43.50558,31350
2334,tbabik,1,0.00319,13640,43.50877,31350
2335,tbrandsma-rw,1,0.00319,13641,43.51196,31350
2336,tdowgielewicz,1,0.00319,13642,43.51515,31350
2337,tdudas,1,0.00319,13643,43.51834,31350
2338,tedder,1,0.00319,13644,43.52153,31350
2339,tejaaa45,1,0.00319,13645,43.52472,31350
2340,telamonian,1,0.00319,13646,43.52791,31350
2341,Telamon-m,1,0.00319,13647,43.53110,31350
2342,terabyte128,1,0.00319,13648,43.53429,31350
2343,teralype,1,0.00319,13649,43.53748,31350
2344,ThatDeveloper,1,0.00319,13650,43.54067,31350
2345,TheRealGramdalf,1,0.00319,13651,43.54386,31350
2346,the-technat,1,0.00319,13652,43.54705,31350
2347,thomas-bingel,1,0.00319,13653,43.55024,31350
2348,ThomasLohmann,1,0.00319,13654,43.55343,31350
2349,thomaspeitz,1,0.00319,13655,43.55662,31350
2350,ThomasRasmussen,1,0.00319,13656,43.55981,31350
2351,Thoulsadoom,1,0.00319,13657,43.56300,31350
2352,thunoldolsen,1,0.00319,13658,43.56619,31350
2353,thuzhf,1,0.00319,13659,43.56938,31350
2354,tiehfood,1,0.00319,13660,43.57257,31350
2355,tijder,1,0.00319,13661,43.57576,31350
2356,timged,1,0.00319,13662,43.57895,31350
2357,tim-jagenberg-piscada,1,0.00319,13663,43.58214,31350
2358,timmalich,1,0.00319,13664,43.58533,31350
2359,timothydlister,1,0.00319,13665,43.58852,31350
2360,timpatt,1,0.00319,13666,43.59171,31350
2361,tinogruse,1,0.00319,13667,43.59490,31350
2362,Tipsmark,1,0.00319,13668,43.59809,31350
2363,tmsquill,1,0.00319,13669,43.60128,31350
2364,tobiasr,1,0.00319,13670,43.60447,31350
2365,toboshii,1,0.00319,13671,43.60766,31350
2366,tomberek,1,0.00319,13672,43.61085,31350
2367,tonydnguyen7,1,0.00319,13673,43.61404,31350
2368,toonvd,1,0.00319,13674,43.61722,31350
2369,topolanekmartin,1,0.00319,13675,43.62041,31350
2370,toxuin,1,0.00319,13676,43.62360,31350
2371,tppalani,1,0.00319,13677,43.62679,31350
2372,trainin99,1,0.00319,13678,43.62998,31350
2373,trajano,1,0.00319,13679,43.63317,31350
2374,tralafiti,1,0.00319,13680,43.63636,31350
2375,transient1,1,0.00319,13681,43.63955,31350
2376,triplebackslash,1,0.00319,13682,43.64274,31350
2377,trumanpurnell,1,0.00319,13683,43.64593,31350
2378,tschechniker,1,0.00319,13684,43.64912,31350
2379,tsiaGeorge,1,0.00319,13685,43.65231,31350
2380,ttn-nguyen42,1,0.00319,13686,43.65550,31350
2381,TwoStone,1,0.00319,13687,43.65869,31350
2382,tyriis,1,0.00319,13688,43.66188,31350
2383,uidmehdi,1,0.00319,13689,43.66507,31350
2384,ujinius,1,0.00319,13690,43.66826,31350
2385,UnDesSix,1,0.00319,13691,43.67145,31350
2386,u-phoria,1,0.00319,13692,43.67464,31350
2387,UpperM,1,0.00319,13693,43.67783,31350
2388,usamaB,1,0.00319,13694,43.68102,31350
2389,user-45-20,1,0.00319,13695,43.68421,31350
2390,UvealSnow,1,0.00319,13696,43.68740,31350
2391,vanschelven,1,0.00319,13697,43.69059,31350
2392,vanyakosmos,1,0.00319,13698,43.69378,31350
2393,venu1412,1,0.00319,13699,43.69697,31350
2394,vfauth,1,0.00319,13700,43.70016,31350
2395,VictorBersy,1,0.00319,13701,43.70335,31350
2396,vijayendrar,1,0.00319,13702,43.70654,31350
2397,vijayreddy29,1,0.00319,13703,43.70973,31350
2398,vince-franco,1,0.00319,13704,43.71292,31350
2399,vincentzhou2013,1,0.00319,13705,43.71611,31350
2400,Vinithk9345,1,0.00319,13706,43.71930,31350
2401,vinzcoco,1,0.00319,13707,43.72249,31350
2402,virtualstaticvoid,1,0.00319,13708,43.72568,31350
2403,vjwilson1987,1,0.00319,13709,43.72887,31350
2404,vkadiwala,1,0.00319,13710,43.73206,31350
2405,vksaamy,1,0.00319,13711,43.73525,31350
2406,voelkle-unige,1,0.00319,13712,43.73844,31350
2407,VolJin,1,0.00319,13713,43.74163,31350
2408,vpginsurley,1,0.00319,13714,43.74482,31350
2409,vprivat-ads,1,0.00319,13715,43.74801,31350
2410,vvarga007,1,0.00319,13716,43.75120,31350
2411,waheb-benzaid,1,0.00319,13717,43.75439,31350
2412,WakeupTsai,1,0.00319,13718,43.75758,31350
2413,wallcrosstype,1,0.00319,13719,43.76077,31350
2414,wangenbao1001,1,0.00319,13720,43.76396,31350
2415,wangkekekexili,1,0.00319,13721,43.76715,31350
2416,wassimbenregaya1,1,0.00319,13722,43.77033,31350
2417,wcom939,1,0.00319,13723,43.77352,31350
2418,wei-z-git,1,0.00319,13724,43.77671,31350
2419,wenchao5211,1,0.00319,13725,43.77990,31350
2420,wesleydebruijn,1,0.00319,13726,43.78309,31350
2421,whg517,1,0.00319,13727,43.78628,31350
2422,will-freshworks,1,0.00319,13728,43.78947,31350
2423,willhargan,1,0.00319,13729,43.79266,31350
2424,wjcarpenter,1,0.00319,13730,43.79585,31350
2425,WolfgangMehner,1,0.00319,13731,43.79904,31350
2426,WolfMa99,1,0.00319,13732,43.80223,31350
2427,wolfram-laube,1,0.00319,13733,43.80542,31350
2428,wonderhoss,1,0.00319,13734,43.80861,31350
2429,WorkAlexGahr,1,0.00319,13735,43.81180,31350
2430,wosc,1,0.00319,13736,43.81499,31350
2431,x45dev,1,0.00319,13737,43.81818,31350
2432,xakaitetoia,1,0.00319,13738,43.82137,31350
2433,xenx-efy,1,0.00319,13739,43.82456,31350
2434,Xeonios,1,0.00319,13740,43.82775,31350
2435,xuluzhen,1,0.00319,13741,43.83094,31350
2436,xwz123,1,0.00319,13742,43.83413,31350
2437,xyxiaobai,1,0.00319,13743,43.83732,31350
2438,y6vmeq,1,0.00319,13744,43.84051,31350
2439,yahyaozturk,1,0.00319,13745,43.84370,31350
2440,yaleman,1,0.00319,13746,43.84689,31350
2441,yanzv,1,0.00319,13747,43.85008,31350
2442,yarongol,1,0.00319,13748,43.85327,31350
2443,Yaytay,1,0.00319,13749,43.85646,31350
2444,yoavo-datricks,1,0.00319,13750,43.85965,31350
2445,yorinasub17,1,0.00319,13751,43.86284,31350
2446,zeeshanshabbir93,1,0.00319,13752,43.86603,31350
2447,ZENALC,1,0.00319,13753,43.86922,31350
2448,zhangjinxu,1,0.00319,13754,43.87241,31350
2449,Ziomal12,1,0.00319,13755,43.87560,31350
2450,zizitop13,1,0.00319,13756,43.87879,31350
2451,zmichael,1,0.00319,13757,43.88198,31350
2452,zoc,1,0.00319,13758,43.88517,31350
2453,zohiba,1,0.00319,13759,43.88836,31350
2454,zxcvb0987,1,0.00319,13760,43.89155,31350
2455,zydjohnHotmail,1,0.00319,13761,43.89474,31350
